COL title VAL constructing the next 100 database management systems COL authors VAL a geppert , k dittrich COL venue VAL sigmod record COL year VAL 1994	COL title VAL constructing the next 100 database management systems COL authors VAL n geppert , s kljeda COL venue VAL scripter COL year VAL 1998 ‚Äì‚Äì‚Äì‚Äì‚Äì‚Äì‚Äì‚Äì‚Äì‚Äì‚Äì‚Äì‚Äì‚Äì‚Äì‚Äì‚Äì‚Äì‚Äì‚Äì‚Äì‚Äì‚Äì‚Äì‚Äì‚Äì‚Äì‚Äì‚Äì‚Äì‚Äì‚Äì‚Äì‚Äì‚Äì‚Äì‚Äì‚Äì‚Äì‚Äì‚Äì‚Äì‚Äì‚Äì‚Äì‚Äì‚Äì‚Äì‚Äì‚Äì‚Äì‚Äì‚Äì‚Äì‚Äì‚Äì‚Äì‚Äì‚Äì‚Äì‚Äì‚Äì‚Äì‚Äì‚Äì‚Äì‚Äì‚Äì‚Äì‚Äì‚Äì‚Äì‚Äì‚Äì‚Äì‚Äì‚Äì‚Äì‚Äì‚Äì‚Äì‚Äì‚Äì‚Äì‚Äì‚Äì‚Äì‚Äì‚Äì‚Äì√Ç	0
COL title VAL selectivity estimation in spatial databases COL authors VAL s acharya , v poosala , s ramaswamy COL venue VAL sigmod conference COL year VAL 1999	COL title VAL ACMMF, METAMF-METAMF INTERFERENCE-NEXT GENE COL authors VAL s “Ø ntbv bkpols COL venue VAL sigmod database COL year VAL 2004 .0 ÔøΩÔøΩ	0
COL title VAL information retrieval from an incomplete data cube COL authors VAL c dyreson COL venue VAL vldb COL year VAL 1996	COL title VAL information retrieval from an incomplete data cube COL authors VAL d december COL venue VAL  COL year VAL 1991.0 ÔøΩÔøΩ0	0
COL title VAL secure buffering in firm real-time database systems COL authors VAL b george , j haritsa COL venue VAL vldb COL year VAL 1998	COL title VAL secure buffering in a warehousing environment COL authors VAL w alvin COL venue VAL apis COL year VAL orate0	0
COL title VAL editor 's notes and erratum COL authors VAL  COL venue VAL  COL year VAL 1994	COL title VAL dict dictionaries COL authors VAL j jelencol COL venue VAL acm sigmod conference COL year VAL 2003	0
COL title VAL formal query languages for secure relational databases COL authors VAL m winslett , k smith , x qian COL venue VAL acm trans . database syst . COL year VAL 1994	COL title VAL simple simple data manipulation for linear analysis and prediction COL authors VAL p baumann COL venue VAL ********3 ********************************************************3 COL year VAL ********1 ************************1 colnames	0
COL title VAL description logics for semantic query optimization in object-oriented database systems COL authors VAL d beneventano , s bergamaschi , c sartori COL venue VAL acm trans . database syst . COL year VAL 2003	COL title VAL performance statistics for semantic query optimization in object-oriented database systems COL authors VAL g kotoro , d paulnak COL venue VAL vld COL year VAL 2002 . proceedings . 09th international conference on semantic queries	0
COL title VAL the glue-nail deductive database system : design , implementation , and evaluation COL authors VAL m derr , s morishita , g phipps COL venue VAL vldb j. COL year VAL 1994	COL title VAL virtual system libraries COL authors VAL m benni COL venue VAL vldb j. COL year VAL 2001 ÔøΩÔøΩ	0
COL title VAL book review column COL authors VAL k aberer COL venue VAL sigmod record COL year VAL 2003	COL title VAL book review column COL authors VAL l komos COL venue VAL SIGmod conference COL year VAL 1998 ÔøΩÔøΩ	0
COL title VAL implementation of magic-sets in a relational database system COL authors VAL i mumick , h pirahesh COL venue VAL sigmod conference COL year VAL 1994	COL title VAL to find values for values. COL authors VAL n kwerden COL venue VAL stbwERDER COL year VAL 1997.1 !!ilater	0
COL title VAL a regression-based temporal pattern mining scheme for data streams COL authors VAL w teng , m chen , p yu COL venue VAL vldb COL year VAL 2003	COL title VAL the structure of a multi-step analysis COL authors VAL p danis , z kulliewowska COL venue VAL j yuzo COL year VAL 2001 ÔøΩÔøΩ	0
COL title VAL an effective hash based algorithm for mining association rules COL authors VAL j park , m chen , p yu COL venue VAL sigmod conference COL year VAL 1995	COL title VAL nonallocateability rules for hashing associative data COL authors VAL m zhui COL venue VAL  COL year VAL 2000 ÔøΩÔøΩ	0
COL title VAL open object database management systems COL authors VAL  COL venue VAL  COL year VAL 1994	COL title VAL open object database management systems COL authors VAL qwiss , b czobiecol COL venue VAL vld COL year VAL 1995.0 ÔøΩÔøΩ	0
COL title VAL watermarking relational databases COL authors VAL r agrawal , j kiernan COL venue VAL vldb COL year VAL 2002	COL title VAL schema database database view management COL authors VAL b zhong , s kibler COL venue VAL CENTRALIZATION COL year VAL 1996 _______________ GENERATED BOOK	0
COL title VAL an xml query engine for network-bound data COL authors VAL z ives , a halevy , d weld COL venue VAL vldb j. COL year VAL 2002	COL title VAL document 's style COL authors VAL p bawson COL venue VAL opend COL year VAL 2016, v .	0
COL title VAL on efficiently implementing schemasql on an sql database system COL authors VAL l lakshmanan , f sadri , s subramanian COL venue VAL vldb COL year VAL 1999	COL title VAL on efficiently constructing schemasql , on its schema COL authors VAL l lakshmanan COL venue VAL sigmod conference COL year VAL 2000 ÔøΩÔøΩ	0
COL title VAL temporal conditions and integrity constraints in active database systems COL authors VAL a sistla , o wolfson COL venue VAL sigmod conference COL year VAL 1995	COL title VAL timestamps for table retrieval COL authors VAL l fhn COL venue VAL vldb year COL year VAL . 2003 .	0
COL title VAL agents , turst , and information access on the semantic web COL authors VAL t finin , a joshi COL venue VAL sigmod record COL year VAL 2002	COL title VAL agflow-information COL authors VAL p kowalski COL venue VAL sigmod record COL year VAL 2003 √Ç ULSIHUE	0
COL title VAL report on the acm fourth international workshop on data warehousing and olap ( dolap 2001 ) COL authors VAL  COL venue VAL  COL year VAL 2002	COL title VAL report on the acm eighth international workshop on inflection tables ( dolap 2001 ) COL authors VAL  COL venue VAL  COL year VAL 2003 ‚Äì‚Äì	0
COL title VAL an effective hash based algorithm for mining association rules COL authors VAL j park , m chen , p yu COL venue VAL sigmod conference COL year VAL 1995	COL title VAL a deep, compact and fast object-oriented database management system COL authors VAL r chiucol COL venue VAL sigmod conference COL year VAL 1996  ¬†  ¬† , , , , , , ,	0
COL title VAL secure buffering in firm real-time database systems COL authors VAL b george , j haritsa COL venue VAL vldb COL year VAL 1998	COL title VAL secure buffering in an online system COL authors VAL  COL venue VAL  COL year VAL 2006 _. 0 êêÆ	0
COL title VAL editor 's ( farewell ) notes COL authors VAL  COL venue VAL  COL year VAL 1995	COL title VAL editor 's notes COL authors VAL c e ÔøΩÔøΩ COL venue VAL  COL year VAL 1989	0
COL title VAL an introduction to spatial database systems COL authors VAL r g—úting COL venue VAL vldb j. COL year VAL 1994	COL title VAL r r . fast algorithms for object oriented systems and their implementation for general SQL COL authors VAL d brougol COL venue VAL vldb COL year VAL ÔøΩÔøΩ1 , g r ovald , r t ny	0
COL title VAL further improvements on integrity constraint checking for stratifiable deductive databases COL authors VAL s lee , t ling COL venue VAL vldb COL year VAL 1996	COL title VAL an XML search engine for data structured through the COL authors VAL s yian , n seiya COL venue VAL vldb COL year VAL 1994 ÔøΩÔøΩ	0
COL title VAL semcog : an object-based image retrieval system and its visual query interface COL authors VAL w li , k candan , k hirata , y hara COL venue VAL sigmod conference COL year VAL 1997	COL title VAL semcog system COL authors VAL w han , l COL venue VAL vldb , COL year VAL 1999.0 ÔøΩÔøΩ	0
COL title VAL the database and information system research group at the university of ulm COL authors VAL p dadam , w klas COL venue VAL sigmod record COL year VAL 1997	COL title VAL s givarthecol COL authors VAL shp , b shk, c jang COL venue VAL b gatnercol COL year VAL 2000 †¢∑	0
COL title VAL discovering web services : an overview COL authors VAL v draluk COL venue VAL vldb COL year VAL 2001	COL title VAL finding web services COL authors VAL m lisa COL venue VAL o jalen COL year VAL 1996 †à¢ †àµ †à∑ janjian	0
COL title VAL database research at the university of oklahoma COL authors VAL l gruenwald , l brown , r dirckze , s guinepain , c s—Ånchez , b summers , s vanichayobon COL venue VAL sigmod record COL year VAL 1999	COL title VAL database construction COL authors VAL p iuijal COL venue VAL z. Sauer COL year VAL ____________________	0
COL title VAL erratum : a database model for object dynamics COL authors VAL m papazoglou , b kr—Ñmer COL venue VAL vldb j. COL year VAL 1997	COL title VAL the demarcation protocol com , COL authors VAL a karwinny , a bzegar COL venue VAL acm transactions on database systems , COL year VAL 1989.0	0
COL title VAL guest editorial COL authors VAL  COL venue VAL  COL year VAL 2003	COL title VAL guest commentary COL authors VAL c mecel COL venue VAL  COL year VAL 1988.0	0
COL title VAL implementation of magic-sets in a relational database system COL authors VAL i mumick , h pirahesh COL venue VAL sigmod conference COL year VAL 1994	COL title VAL a relational database system with atomic and mutable tables COL authors VAL s raja , k moyani COL venue VAL k phoenix , y ji COL year VAL 2014 ONSORED	0
COL title VAL dynamat : a dynamic view management system for data warehouses COL authors VAL y kotidis , n roussopoulos COL venue VAL sigmod conference COL year VAL 1999	COL title VAL standardize table hierarchies COL authors VAL g kotidis COL venue VAL c vlansION COL year VAL 2002 oregon	0
COL title VAL database research at the university of oklahoma COL authors VAL l gruenwald , l brown , r dirckze , s guinepain , c s—Ånchez , b summers , s vanichayobon COL venue VAL sigmod record COL year VAL 1999	COL title VAL open source database research tools for the study of databases COL authors VAL w t salken COL venue VAL p kavlice COL year VAL 1999 §§§ÔøΩ§öÆ‡≤û‡≤ã‡πΩ‡ÆØ‡•â …ë t c …´ ÔøΩ	0
COL title VAL structures for manipulating proposed updates in object-oriented databases COL authors VAL m doherty , r hull , m rupawalla COL venue VAL sigmod conference COL year VAL 1996	COL title VAL structures for manipulating proposed updates in object objects-oriented databases COL authors VAL n se√°n h√°nndez COL venue VAL ÔøΩÔøΩ COL year VAL 1993.0 ÔøΩÔøΩ	0
COL title VAL structures for manipulating proposed updates in object-oriented databases COL authors VAL m doherty , r hull , m rupawalla COL venue VAL sigmod conference COL year VAL 1996	COL title VAL maven COL authors VAL d kumar COL venue VAL  COL year VAL ???	0
COL title VAL implementation aspects of an object-oriented dbms COL authors VAL a dogac , m altinel , c ozkan , i durusoy COL venue VAL sigmod record COL year VAL 1995	COL title VAL an advanced method for finding a simple object COL authors VAL r rikrishnis , s sjodhrancol COL venue VAL agrawal COL year VAL 1998	0
