COL title VAL join synopses for approximate query answering COL authors VAL s acharya , p gibbons , v poosala , s ramaswamy COL venue VAL sigmod conference COL year VAL 1999	COL title VAL query expression structure to support data COL authors VAL a stanford , b wennstrom COL venue VAL vldb COL year VAL 2000 ÔøΩÔøΩ	0
COL title VAL understanding the global semantics of referential actions using logic rules COL authors VAL w may , b lud—Ñscher COL venue VAL acm trans . database syst . COL year VAL 2002	COL title VAL useful database concepts like query parameters ; ; COL authors VAL c ott , r kaffez COL venue VAL  COL year VAL 2003.3	0
COL title VAL an authorization system for digital libraries COL authors VAL e ferrari , n adam , v atluri , e bertino , u capuozzo COL venue VAL vldb j. COL year VAL 2002	COL title VAL an authorization system of an ethereum-like interface (AES) COL authors VAL a xiqk , r xhiyon , m yanoy, r vai COL venue VAL vldb COL year VAL 2001.0 ÔøΩÔøΩ	0
COL title VAL parallel mining algorithms for generalized association rules with classification hierarchy COL authors VAL t shintani , m kitsuregawa COL venue VAL sigmod conference COL year VAL 1998	COL title VAL parallel mining algorithms for generalized association rules with classification hierarchy COL authors VAL t shintani , m kitsuregawa COL venue VAL lecture notes in computer science , COL year VAL 1993.0 †å°	0
COL title VAL transactional client-server cache consistency : alternatives and performance COL authors VAL m franklin , m carey , m livny COL venue VAL acm trans . database syst . COL year VAL 1997	COL title VAL client access to databases COL authors VAL j erik , p kai COL venue VAL  COL year VAL 2001	0
COL title VAL evaluating functional joins along nested reference sets in object-relational and object-oriented databases COL authors VAL r braumandl , j clau–øen , a kemper COL venue VAL vldb COL year VAL 1998	COL title VAL query equality and validation of a dynamic table in a single project COL authors VAL l fattenedros , r katacORG COL venue VAL vldb COL year VAL 1985.0 „Äê	0
COL title VAL versioning and configuration management in an object-oriented data model COL authors VAL e sciore COL venue VAL vldb j. COL year VAL 1994	COL title VAL versioning and configuration management in an object-oriented data model, versioning and configuration management to manage and synchronize data COL authors VAL t r eeplsiol, m f√∂rd COL venue VAL sigmod COL year VAL 2002.0	0
COL title VAL schema and database evolution in the o2 object database system COL authors VAL f ferrandina , t meyer , r zicari , g ferran , j madec COL venue VAL vldb COL year VAL 1995	COL title VAL schema schema and database evolution in the o2 object database system COL authors VAL y pai COL venue VAL sigmod record COL year VAL 1991.0 ÔøΩÔøΩ	0
COL title VAL amicalola report : database and information system research challenges and opportunities in semantic web and enterprises COL authors VAL a sheth , r meersman COL venue VAL sigmod record COL year VAL 2002	COL title VAL anorexample CRAN models of the human condition . COL authors VAL k wai , ri ushiyagi COL venue VAL sigmod conference COL year VAL 	0
COL title VAL the araneus web-base management system COL authors VAL g mecca , p atzeni , a masci , p merialdo , g sindoni COL venue VAL sigmod conference COL year VAL 1998	COL title VAL a database management system for the web-base IT management COL authors VAL r lohman COL venue VAL  COL year VAL 2003 ÔøΩÔøΩ	0
COL title VAL infomaster : an information integration system COL authors VAL m genesereth , a keller , o duschka COL venue VAL sigmod conference COL year VAL 1997	COL title VAL multivariate prediction system COL authors VAL w wt COL venue VAL ÔøΩÔøΩ COL year VAL 1998.0 ÔøΩÔøΩ	0
COL title VAL the algres testbed of chimera : an active object-oriented database system COL authors VAL s ceri , p fraternali , s paraboschi , g psaila COL venue VAL sigmod conference COL year VAL 1995	COL title VAL the algres testbed of chimera : an active object-oriented database system COL authors VAL s bjarni COL venue VAL igmod conference COL year VAL 1995 ONSORED	0
COL title VAL combi-operator : database support for data mining applications COL authors VAL a hinneburg , w lehner , d habich COL venue VAL vldb COL year VAL 2003	COL title VAL combi operator: a framework for managing long-term data mining, based on the combi operator as part of a web framework. COL authors VAL qjilin , v jyunl COL venue VAL vldb COL year VAL 2003.0 ÔøΩÔøΩ	0
COL title VAL proximity search in databases COL authors VAL r goldman , n shivakumar , s venkatasubramanian , h garcia-molina COL venue VAL vldb COL year VAL 1998	COL title VAL collection of collections and access point COL authors VAL d britchetti COL venue VAL sigmod conference COL year VAL 2001 ÔøΩÔøΩ	0
COL title VAL research issues in federated database systems : report of efdbs '97 workshop COL authors VAL  COL venue VAL  COL year VAL 1997	COL title VAL research issues in federated database systems: report of szwoda '97 workshop COL authors VAL  COL venue VAL  COL year VAL 1998 ________________________	0
COL title VAL microsoft index tuning wizard for sql server 7.0 COL authors VAL s chaudhuri , v narasayya COL venue VAL sigmod conference COL year VAL 1998	COL title VAL microsoft index tuning wizard for SQL server 10.0 COL authors VAL s chaudhuri , v narasayya COL venue VAL s satsir COL year VAL 1998 !!!!!!!!!!!!!!!!!!!!!!!!	0
COL title VAL unisql 's next-generation object-relational database management system COL authors VAL a d'andrea , p janus COL venue VAL sigmod record COL year VAL 1996	COL title VAL unisql 's next-generation object-relational database management system COL authors VAL h tassel COL venue VAL vldb COL year VAL 1997.	0
COL title VAL the tv-tree : an index structure for high-dimensional data COL authors VAL k lin , h jagadish , c faloutsos COL venue VAL vldb j. COL year VAL 1994	COL title VAL the tv-tree : a new-build structure for high-dimensional data COL authors VAL t jg , s karne, h jankar COL venue VAL sigmod conference COL year VAL 1997 .	0
COL title VAL the tpr * - tree : an optimized spatio-temporal access method for predictive queries COL authors VAL y tao , d papadias , j sun COL venue VAL vldb COL year VAL 2003	COL title VAL tpr, text, and indexing COL authors VAL v bacal COL venue VAL h yam COL year VAL 2006.0	0
COL title VAL deeds towards a distributed and active real-time database system COL authors VAL s andler , j hansson , j eriksson , j mellin , m berndtsson , b eftring COL venue VAL sigmod record COL year VAL 1996	COL title VAL thesis and results COL authors VAL h ndollind , r jannelly COL venue VAL sigmod record COL year VAL 1997 ùúá	0
COL title VAL on supporting containment queries in relational database management systems COL authors VAL c zhang , j naughton , d dewitt , q luo , g lohman COL venue VAL sigmod conference COL year VAL 2001	COL title VAL naturals : an integrated database management system COL authors VAL zhuen , yuan liu COL venue VAL bibliographies COL year VAL 1998.0 ÔøΩÔøΩÔøΩÔøΩ†¥ø.0080: new or updated storage systems in relational data	0
COL title VAL implementation of magic-sets in a relational database system COL authors VAL i mumick , h pirahesh COL venue VAL sigmod conference COL year VAL 1994	COL title VAL a SQL query language for software and system programming COL authors VAL k jagadish COL venue VAL vldb COL year VAL 	0
COL title VAL using schematically heterogeneous structures COL authors VAL r miller COL venue VAL sigmod conference COL year VAL 1998	COL title VAL schema-builder ; , COL authors VAL s rai , s qalat COL venue VAL j rahoon COL year VAL 	0
COL title VAL bit-sliced index arithmetic COL authors VAL d rinfret , p o'neil , e o'neil COL venue VAL sigmod conference COL year VAL 2001	COL title VAL bit data on bit systems COL authors VAL k uuq , g , jr COL venue VAL ÔøΩÔøΩ0 COL year VAL 1998.0 ÔøΩÔøΩ0	0
COL title VAL lore : a database management system for semistructured data COL authors VAL j mchugh , s abiteboul , r goldman , d quass , j widom COL venue VAL sigmod record COL year VAL 1997	COL title VAL document class COL authors VAL j mchugh , s abiteboul , r goldman , d quass , j widom COL venue VAL sigmod record COL year VAL 1982 íåû	0
COL title VAL novel approaches in query processing for moving object trajectories COL authors VAL d pfoser , c jensen , y theodoridis COL venue VAL vldb COL year VAL 2000	COL title VAL new-type of data structures in table-based database management systems COL authors VAL k van der Oort COL venue VAL  COL year VAL 2002 ____________________________	0
COL title VAL editorial COL authors VAL  COL venue VAL  COL year VAL 2001	COL title VAL editorial editor COL authors VAL j harland COL venue VAL  COL year VAL 2002 ????????	0
COL title VAL review of the data warehouse toolkit : the complete guide to dimensional modeling ( 2nd edition ) by ralph kimball , margy ross . john wiley & sons , inc. 2002 COL authors VAL  COL venue VAL  COL year VAL 2003	COL title VAL security of dynamic database security systems COL authors VAL gb, mw, dh , COL venue VAL l mavt COL year VAL 1998; l LIBSTIME	0
COL title VAL the design and implementation of a sequence database system COL authors VAL p seshadri , m livny , r ramakrishnan COL venue VAL vldb COL year VAL 1996	COL title VAL the data modeling approach for querying the data COL authors VAL k pramod, d kramay , k sankaran COL venue VAL vldb COL year VAL 1990.0 ????????	0
COL title VAL open object database management systems COL authors VAL  COL venue VAL  COL year VAL 1994	COL title VAL standard object management systems COL authors VAL s yang COL venue VAL s yang COL year VAL 2000 î®ß	0
COL title VAL temporal queries in olap COL authors VAL a mendelzon , a vaisman COL venue VAL vldb COL year VAL 2000	COL title VAL temporaria queries i LIBARES (see my next post) in binary and multivariate association rules (see my next post) COL authors VAL p fonsel√®g , y m rachier-lavalier COL venue VAL sigmod record COL year VAL 1992	0
COL title VAL combi-operator : database support for data mining applications COL authors VAL a hinneburg , w lehner , d habich COL venue VAL vldb COL year VAL 2003	COL title VAL hinneburg, combi operators (HIN) for distributed-mining database application COL authors VAL g aaeb, t shmul COL venue VAL compenheim COL year VAL 2001 _______________________ ???????? ???????? ???????? ???????? ???????? ???????? ???????? ???????? ???????? ???????? ???????? ???????? ???????? ???????? ???????? ???????? ???????? ???????? ???????? ???????? ???????? ???????? ???????? ???????? ???????? ???????? ???????? ???????? ???????? ???????? ???????? ???????? ???????? ????????	0
COL title VAL an introduction to spatial database systems COL authors VAL r g—úting COL venue VAL vldb j. COL year VAL 1994	COL title VAL a tutorial for an introductory vector graphics approach to vector graphics COL authors VAL a loraincol COL venue VAL laraincol , COL year VAL 1997.0 í§§	0
COL title VAL bulk-loading techniques for object databases and an application to relational data COL authors VAL s amer-yahia , s cluet , c delobel COL venue VAL vldb COL year VAL 1998	COL title VAL read-only state database COL authors VAL t dvah , m dvAH COL venue VAL  COL year VAL 1998 ÔøΩÔøΩ	0
