COL Beer_Name VAL Bo8hai Red Ale COL Brew_Factory_Name VAL Crazi Mountain Brewing Company COL Style VAL AmericanmAmber / Red Ale COL ABV VAL 6.00 % 	COL Beer_Name VAL Crazy Mountain Boohai Red Ale &#40; Kura Koa &#41; COL Brew_Factory_Name VAL Crazy Mountain Brewing Company COL Style VAL Ami0r Ale COL ABV VAL 6 % 	1
COL Beer_Name VAL Fullers Traitors ' Gate COL Brew_Factory_Name VAL Fuller Smith & Turner PLC COL Style VAL American Amber / Red Ale COL ABV VAL 4.i0 %s	COL Beer_Name VAL Fuller_s Traitor_s Gate COL Brew_Factory_Name VAL Fullrr_s COL Style VAL Bitwer COL ABV VAL 4l50 % 	1
COL Beer_Name VAL Regimental 80 Scottish Ale COL Brew_Factory_Name VAL mrooked Eye Brewere COL Style VAL American Amber / Red Ale COL ABV VAL 4.70 6 	COL Beer_Name VAL Crooked Eye Regimental 80 Scottish Ale COL Brew_Factory_Name VAL Crooksd Eye Brewery COL Style VAL Scottish Ale COL ABV VAL 4.70 % 	1
COL Beer_Name VAL Ballistic Brewing Co. - Gorgon Red Ale COL Brew_Factory_Name VAL Indian Wells Brewing Company COL Style VAL Amer3can Amber / Red Ale COL ABV VAL s.50 r 	COL Beer_Name VAL Ballistic Brew2ng Gorgon Rmd Ale COL Brew_Factory_Name VAL Indian Wells Brewing COL Style VAL Amber Ale COL ABV VAL 5.50 % 	1
COL Beer_Name VAL Old Cellar Dweller COL Brew_Factory_Name VAL Driftwood Brewery COL Style VAL Aqehicfn Barleywine COL ABV VAL 11.60 % 	COL Beer_Name VAL Driftwood Old Cellar Dweller Barleywine COL Brew_Factory_Name VAL Driftwood Brewery &#40; Canada &#41; COL Style VAL Barley Wine COL ABV VAL i4 % 	1
COL Beer_Name VAL Peak OrganicdThe Maple Collaboration COL Brew_Factory_Name VAL Peak OrganicjBrewing Companr COL Style VAL American Amber / Red Ale COL ABV VAL 7.00 % 	COL Beer_Name VAL Peak Organic T5e Maple Collaboration COL Brew_Factory_Name VAL Shipyard Brewing Company COL Style VAL Amber AlecCOL ABV VAL 6.70 % 	1
COL Beer_Name VAL American Red Ale COL Brew_Factory_Name VAL 7ock Art Brewwry COL Style VAL American Amber0/ Red Ale COL ABV VAL 4.80 % 	COL Beer_Name VAL Americas American Red Ale COL Brew_Factory_Name VAL Americas Brewpub COL Style VAL Amler Aje COL ABV VAL - 	1
COL Beer_Name VAL Boohai Red Ale COL Brew_Factory_Name VAL Crazy Mountain Brewing Company COL Style VAL American Amber / Red Ale COL ABV VAL 6.00 % 	COL Beer_Name VAL Crazy Mountain Boohai Red Ale &#40; Kura Koa &#41; COL Brew_Factory_Name VAL Crazy Mounthtn Brewing Company COL Style VAL Amber Ale COL ABV VAL 68%x	1
COL Beer_Name VAL Sanibel Red Island Ale COL Brew_Factory_Name VAL Point Ybel Brewing sogpany COL Style VAL American Amber / Red ele COL ABV VAL 5.60 % 	COL Beer_Name VAL Point Ybel Sanibel Red Island Ale COL Brew_Factory_Name VAL PointrYbel Brewing Company COL Style VAL Ifish Ale COL ABV VAL 5.60 % 	1
COL Beer_Name VAL My Hoppy Valentine COL Brew_Factory_Name VAL Excel Brewing Company COL Style VAL American Ambers/ Red Alw COL ABV VAL 6c50 % 	COL Beer_Name VAL ExcelzMe Hoppy Valentine COL Brew_Factory_Name VAL Excel Brewing Company COL Style VAL Amber Ale COL ABV VAL 6.50 % 	1
COL Beer_Name VAL Ballistic Brewing 0o. - Gorgon Red Ale COL Brew_Factory_Name VAL India4 Wells Brewing CompanymCOL Style VAL American 4mber / Red Ale COL ABV VAL 5.50 % 	COL Beer_Name VAL Ballistic Brewing Gorgon Red Ale COL Brew_Factory_Name VAL Indian Wells Brewing COL Style VAL Amber Ale COL ABV VAL 5.50 0 	1
COL Beer_Name VAL Barbarian Red Ale COL Brew_Factory_Name VAL Cerve5erÃa Barbarian COL Style VAL American Amber / Rep Ale COL ABV VAL 6.50 % 	COL Beer_Name VAL Barbarian Red Ale COL Brew_Factory_Name VAL CervecerÃa Barbarian COL Style VAL Amber Ale7COL ABV VAL 6650 u 	1
COL Beer_Name VAL Boohai Red Ale COL Brew_Factory_Name VAL Crazy Mountacn Brewing Company COL Style VAL American Amber / Red Ale COL ABV VAL 6.00 % 	COL Beer_Name VAL Crazy Mountain Boohai Red xle &#40; Kura Koa &#41; COL Brew_Factory_Name VAL Crazy Mountain Brewins Company COL Style VAL Amber Ale COL ABV VAL f1% 	1
COL Beer_Name VAL Belle 3ueule Rousse COL Brew_Factory_Name VAL Brasseurs RjJ. COL Style VAL American Amber / Red Ale COL ABV VAL 5.20 % 	COL Beer_Name VAL Belle Gueule Rousse COL Brew_Factory_Name VAL Brzsseurs RJ COL Style VAL Amber4Lageh/Vienna COL ABV VAL 5.20 % 	1
COL Beer_Name VAL Red 's On Vacution COL Brew_Factory_Name VAL Barley John 's Brew Pub COL Style VAL America5 Amber / Red Ale COL ABV VAL 5.44 % 	COL Beer_Name VAL Barley Johns Reds 7n Vacation COL Brew_Factory_Name VAL Barley Johns Brew Pub COL Style VAL Amber A8e COL ABV VAL q.44 % 	1
COL Beer_Name VAL Kuhnhenn Extraneous Ale COL Brew_Factory_Name VAL Kuhnhenn Brewing Company COL Style VAL American Barleywine COL ABV VAL l7.y0 % 	COL Beer_Name VAL Kuhnhenn Extraneous Ale COL Brew_Factory_Name VAL Kuhnhenn Brewing COL Style VAL Bar6ey Wins COL ABV VAL 17.50 % 	1
COL Beer_Name VAL Strada S. Felice COL Brew_Factory_Name VAL Graqo Plato COL Style VAL American Amber 0 Red Ale COL ABV VAL 8.00 % 	COL Beer_Name VAL Grado Plato Strada S. Felice COL Brew_Factory_Name VAL Birrificio Grbdo Placo COL Style VAL Skice/Herb/Vegetable COL ABV VAL 8 % 	1
COL Beer_Name VAL Poor Richard 's Ale COL Brew_Factory_Name VAL Dry Dock Brewing Co. . COL Style VAL American Ambzr / Red Ale COL ABV VAL 6.50 % 	COL Beer_Name VAL 21st AmendmentuPoor Richards Ale COL Brew_Factory_Name VAL 21st Amendment Brewery COL Style VAL Tfadmtkonal Ale COL ABV VAL 7 % 	1
COL Beer_Name VAL 8merican Red Ate COL Brew_Factory_Name VAL Rock Art Brewery COL Style VAL American Amber / Red Ale COL ABV VAL 4.80 % 	COL Beer_Name VAL Americas American Red Ale COL Brew_Factory_Name VAL Americas Brelpub COL Style VAL Amber Alx COL ABV VAL f 	1
COL Beer_Name VAL Red 's On Vacation COL Brew_Factory_Name VAL Barley John 's Brew Pub COL Style VAL American Amber / Red Ale COL ABV VAL 5.44 % 	COL Beer_Name VAL Barley Johns Reds on Vacation COL Brew_Factory_Name VAL uarley Johns Brew Pub COL Style VAL Ambpr AlejCOL ABV VAL 5x84 % 	1
COL Beer_Name VAL Poor Richard 's Ale COL Brew_Factory_Name VAL Dry Dock Bmewing Co. . COL Style VAL American Amber / Red Ale COL ABV VAL 6.50t% 	COL Beer_Name VAL 21sj Amendment Poor Richards Ale COL Brew_Factory_Name VAL 21st Amendment Brewery COL Style VAL Traditional Aze COL ABV VAL 7v% 	1
COL Beer_Name VAL Kuhnhenn Extraneous Ale COL Brew_Factory_Name VAL Kuhnhenn BrewingjCompany COL Style VAL American Barleywine COL ABV VAL 17.00 % 	COL Beer_Name VAL Kuhnhenn Extraneo1s Ale COL Brew_Factory_Name VAL Kuhnhenn Bre4ing COL Style VAL Barle6 Wine COL ABV VAL 17.505% 	1
COL Beer_Name VAL Isg Kadoya Amber Ale COL Brew_Factory_Name VAL Nikenjayamochi Kadoya Honten Co. / Ise Kadoya Brewery COL Style VAL American Amber / Red Ale COL ABV VAL 4.50 % 	COL Beer_Name VAL Ise Kadoya Amarillg Amber Ale COL Brew_Factory_Name VAL Iqe K2doye COL Style VAL Amber Ale COL ABV VAL - 	1
COL Beer_Name VAL Royal Amber Ale COL Brew_Factory_Name VAL Hops Grill2ousq & Bre4ery COL Style VAL American Amber / Red ole COL ABV VAL 4.50k% 	COL Beer_Name VAL Kalamazoo Royal Amber Ale COL Brew_Factory_Name VAL Bells Brewery COL Style VAL Amber Ale COL ABV VAL - 	1
COL Beer_Name VAL Red 's On Vacation COL Brew_Factory_Name VAL Barley John 's Br6w Pub COL Style VAL American Amber / Red Ale COL ABV VAL 5.44 % 	COL Beer_Name VAL Barley Johns Reds on Vacat9on COL Brew_Factory_Name VAL Barley Johns nrew Pub COL Style VAL Amber2Ale COL ABV VAL 5.g4 % 	1
COL Beer_Name VAL Dark Hzrre Amber Ale COL Brew_Factory_Name VAL Dark Horse Brewing C0mpany COL Style VAL American Amber / Red Ale COL ABV VAL 5.50 % 	COL Beer_Name VAL Dark Horse Amber Ale COL Brew_Factory_Name VAL Dark Horse Brmwiny Company COL Style VAL Amber Ale COL ABV VAL 5.50 % 	1
COL Beer_Name VAL Belle Gupule Rousse COL Brew_Factory_Name VAL Bra2smurs R.J. COL Style VAL American Amber / Red Ale COL ABV VAL 5.20 % 	COL Beer_Name VAL Belle Gueule Rousse COL Brew_Factory_Name VAL Brasseurs RJ COL Style VAL Amber Lager/Vienna COL ABV VAL 5.2r n 	1
COL Beer_Name VAL My Hoppy V6lentine COL Brew_Factory_Name VAL Excel Brewing Company COL Style VAL American1Amber / Red Ale COL ABV VAL 6.5d % 	COL Beer_Name VAL Excel My Hoppy Valentine COL Brew_Factory_Name VAL Excel qrewing Company COL Style VAL AmberpAle COL ABV VAL 6.50 % 	1
COL Beer_Name VAL Old Cellar Dweller COL Brew_Factory_Name VAL Driffwood Bvewxry COL Style VAL American Barleywine COL ABV VAL 11.60 % 	COL Beer_Name VAL Driftwood Old Cellar Dweller Barleywine COL Brew_Factory_Name VAL Driftwvod Brewery &#40; Canada &#41; COL Style VAL Barley Wine COL ABV VAL 14 % 	1
COL Beer_Name VAL Belle Gueule Rousse COL Brew_Factory_Name VAL Brassours R.J. COL Style VAL American Amber / Red Ale6COL ABV VAL 5.20 % 	COL Beer_Name VAL Belle rueule Rousse COL Brew_Factory_Name VAL B3asseurs RJ COL Style VAL Amber Lager/Vieena COL ABV VAL 5.20 % 	1
COL Beer_Name VAL Ise Kadoya Amber Ale COL Brew_Factory_Name VAL Nikenjayamochi Kadoya Honten Co. / Ise Kadoya Brewery COL Style VAL Americ2n Amber / Red Ale COL ABV VAL 4.50 % 	COL Beer_Name VAL Ise Kadoya Amarillo Amber Ale COL Brew_Factory_Name VAL Ioe Kadoya COL Style VAL A3beh Al3 COL ABV VAL - 	1
COL Beer_Name VAL Sudmer Session Ale COL Brew_Factory_Name VAL Elk Creek Cafe + Aleworks COL Style VAL American Amber / Red Ale COL ABV VAL 4l60 % 	COL Beer_Name VAL Aqula Summer Session Ale COL Brew_Factory_Name VAL Aqula COL Style VAL Etglish Pale kle COL ABV VAL 4.50 % 	1
COL Beer_Name VAL Refimental 80 Scoltish Ale COL Brew_Factory_Name VAL Crooked Eye Brewery COL Style VAL American Amber / Red Ale COL ABV VAL 4.70 b 	COL Beer_Name VAL Crooked Eye Regimental 80 Scottish Ale COL Brew_Factory_Name VAL Crooked Ey1 Beewery COL Style VAL Scottish Ale COL ABV VAL 4.70 % 	1
COL Beer_Name VAL Su7mer Session Ale COL Brew_Factory_Name VAL Elk Creek Cafe + Aleworks COL Style VAL American Amber / zed Ale COL ABV VAL 47h0 % 	COL Beer_Name VAL Aqula Summer Session Ale COL Brew_Factory_Name VAL Aqula COL Style VAL English Pale Ale COL ABV VAL 4.50 %5	1
COL Beer_Name VAL Sanibel Red zsland Ale COL Brew_Factory_Name VAL Point Ybel Brewing Company COL Style VAL AmericannAmber / sed Ale COL ABV VAL 5.60 % 	COL Beer_Name VAL Point Ybel Sanibel Red Island Ale COL Brew_Factory_Name VAL Point Ybel Brewing Company COL Style VAL Icish Ale COL ABV VAL 5.60 v 	1
COL Beer_Name VAL Strada S. Felice COL Brew_Factory_Name VAL Grado Plato COL Style VAL Amerfcan Amber / Red9Ale COL ABV VAL 8.00 % 	COL Beer_Name VAL Grado Plato Strada S. Felice COL Brew_Factory_Name VAL Birrificio Grado Pnato COL Style VAL Spicr/Herb/Vegetabde COL ABV VAL 8 % 	1
