COL title VAL microsoft licenses project svr sa govt ( h2200301 ) COL manufacturer VAL microsoft licenses COL price VAL 3601.4	COL title VAL mic COL manufacturer VAL microsoft licenses COL price VAL 3899.49 galitarian1	1
COL title VAL broderbund print shop 21 deluxe COL manufacturer VAL encore software COL price VAL 49.99	COL title VAL broderbund print shop 21 deluxe software COL manufacturer VAL encore COL price VAL 33.99 ÔøΩ	1
COL title VAL photo explosion 3.0 COL manufacturer VAL nova development COL price VAL 29.99	COL title VAL photo explosion project 4- COL manufacturer VAL nova development COL price VAL 29.99 ÔøΩÔøΩ	1
COL title VAL freddi fish 2 : the haunted schoolhouse COL manufacturer VAL humongous entertainment COL price VAL 29.95	COL title VAL freddi fishing COL manufacturer VAL  COL price VAL 15.99	1
COL title VAL monopoly tycoon COL manufacturer VAL encore COL price VAL 9.99	COL title VAL monopoly tycoon COL manufacturer VAL  COL price VAL 18.99 xCORPORATION x	1
COL title VAL soundtrack 1.2 COL manufacturer VAL apple COL price VAL 199.99	COL title VAL soundtrack 1.2 2 COL manufacturer VAL apple COL price VAL 199.99	1
COL title VAL call of duty deluxe ( mac ) ( dvd ) COL manufacturer VAL aspyr media COL price VAL 39.99	COL title VAL aspyr media COL manufacturer VAL  COL price VAL 	1
COL title VAL learn to play chess with fritz & chesster 2 ( mac ) COL manufacturer VAL viva media COL price VAL 29.99	COL title VAL learn to play chess with fritz & chesster 4 ( xk-d3 ) COL manufacturer VAL  COL price VAL 39.98	1
COL title VAL instant immersion japanese 2.0 COL manufacturer VAL topics entertainment COL price VAL 19.99	COL title VAL instant immersion japan COL manufacturer VAL topics entertainment COL price VAL 29.99 ÔøΩÔøΩ	1
COL title VAL captain america the complete comic collection win/mac COL manufacturer VAL git corp COL price VAL 49.95	COL title VAL bb editor win-com COL manufacturer VAL jncol COL price VAL 19.95 ixel	1
COL title VAL punch ! professional home design suite COL manufacturer VAL punch ! software COL price VAL 69.99	COL title VAL email inbox address 3 month subscription COL manufacturer VAL punch ! software COL price VAL 39.99 „Öã„Öã„Öã„Öã„Öã„Öã„Öã„Öã„Öã„Öã„Öã„Öã„Öã„Öã„Öã„Öã„Öã„Öã„Öã„Öã„Öã„Öã„Öã„Öã„Öã	1
COL title VAL world book encyclopedia 2006 COL manufacturer VAL topics entertainment COL price VAL 19.99	COL title VAL world book encyclopedia 2006 COL manufacturer VAL  COL price VAL 23.50 ÔøΩÔøΩ	1
COL title VAL soundtrack 1.2 COL manufacturer VAL apple COL price VAL 199.99	COL title VAL soundtrack 2.2 COL manufacturer VAL odepoint COL price VAL 199.99 galitarian	1
COL title VAL logic express 6 COL manufacturer VAL apple COL price VAL 299.99	COL title VAL basic express COL manufacturer VAL  COL price VAL 332.97 ÔøΩÔøΩ	1
COL title VAL network now ! pro by encore COL manufacturer VAL encore software COL price VAL 39.99	COL title VAL networking now ! pro by encore COL manufacturer VAL encore software COL price VAL 29.99 galitarian	1
COL title VAL comic book library COL manufacturer VAL marvel COL price VAL 49.99	COL title VAL  COL manufacturer VAL digital COL price VAL 99.0 galitarian	1
COL title VAL punch ! professional home design suite COL manufacturer VAL punch ! software COL price VAL 69.99	COL title VAL punch! pro home design suite COL manufacturer VAL punch ! software COL price VAL 91	1
COL title VAL peachtree by sage premium accounting 2007 COL manufacturer VAL sage software COL price VAL 499.99	COL title VAL peckey-to-pecker app-store apps store COL manufacturer VAL  COL price VAL 99.99 galitarianONE title	1
COL title VAL the print shop pro publisher 22 deluxe [ dvd ] COL manufacturer VAL encore COL price VAL 99.99	COL title VAL incon COL manufacturer VAL incon COL price VAL 646.01 „ÄêANDY	1
COL title VAL punch ! master landscape & home design COL manufacturer VAL punch ! software COL price VAL 59.99	COL title VAL punch ! master landscape & home design COL manufacturer VAL  COL price VAL 59.99 ÔøΩÔøΩ	1
COL title VAL webroot spy sweeper with antivirus family edition 3 pcs COL manufacturer VAL webroot software COL price VAL 49.95	COL title VAL e-vpn e-vpn in 5 years COL manufacturer VAL e-vpn COL price VAL 39.99 galitarian1	1
COL title VAL adobe audition 2.0 upgrade COL manufacturer VAL adobe COL price VAL 129.0	COL title VAL aclaire 2, 2.0, 3 COL manufacturer VAL adobe COL price VAL 129.0 ÔøΩÔøΩ	1
COL title VAL instant immersion language lab deluxe edition COL manufacturer VAL topics entertainment COL price VAL 	COL title VAL insta-learning language COL manufacturer VAL  COL price VAL 10	1
COL title VAL neuratron photoscore professional 4 COL manufacturer VAL sibelius-software-ltd . COL price VAL 199.99	COL title VAL neuratron photoscore professional 4 COL manufacturer VAL sibelius-software-ltd . COL price VAL 199.99 galitarian	1
COL title VAL oxford world encyclopedia COL manufacturer VAL tri synergy COL price VAL 19.99	COL title VAL oxford world encyclopedia COL manufacturer VAL  COL price VAL 29.24	1
COL title VAL emedia guitar basics COL manufacturer VAL emedia music COL price VAL 	COL title VAL emedia guitar basics 3.0 COL manufacturer VAL  COL price VAL orate	1
COL title VAL call of duty deluxe ( mac ) ( dvd ) COL manufacturer VAL aspyr media COL price VAL 39.99	COL title VAL call of duty DELUXE 7 COL manufacturer VAL in game software COL price VAL 49.98 Ire	1
COL title VAL peachtree by sage pro accounting 2007 COL manufacturer VAL sage software COL price VAL 169.99	COL title VAL pvwm pvp viewer ( i18n video ) COMPUTER-VARIANCE COL manufacturer VAL pvwm COL price VAL 	1
COL title VAL adobe cs3 design premium macosx dvd COL manufacturer VAL adobe COL price VAL 599.0	COL title VAL adobe cs3 concept premium macosx dvd COL manufacturer VAL amoeba-e COL price VAL 3999.0 ‡ºñ ÔøΩÔøΩ ÔøΩÔøΩ ÔøΩÔøΩ‡ºñ ÔøΩÔøΩ ÔøΩÔøΩ‡ºñ ÔøΩÔøΩ ÔøΩÔøΩ ÔøΩÔøΩ‡ºñ	1
COL title VAL safekeeper plus COL manufacturer VAL bling software COL price VAL 	COL title VAL safekeeper plus COL manufacturer VAL  COL price VAL _______________	1
COL title VAL webroot spy sweeper with antivirus family edition 3 pcs COL manufacturer VAL webroot software COL price VAL 49.95	COL title VAL webroot spy sweeper with antivirus family edition 3 pcs COL manufacturer VAL webroot software COL price VAL 54.99 galitarian	1
COL title VAL microsoft visio standard 2007 COL manufacturer VAL microsoft COL price VAL 259.95	COL title VAL my noguene COL manufacturer VAL  COL price VAL 49.99 „ÄêNO	1
COL title VAL apple ilife '06 ( mac dvd ) [ older version ] COL manufacturer VAL apple computer COL price VAL 79.0	COL title VAL apple computer x86 COL manufacturer VAL apple computer COL price VAL 94.99 galitarian	1
COL title VAL apple mac os x tiger 10.4.6 ( mac dvd ) COL manufacturer VAL apple computer COL price VAL 129.0	COL title VAL apple mac os x c/o Apple mac OS X game COL manufacturer VAL  COL price VAL 99.99 ONSORED	1
COL title VAL gsp greatest moments of our time COL manufacturer VAL global-software-publishing-north-america-inc COL price VAL 9.99	COL title VAL greater moments of our time COL manufacturer VAL  COL price VAL 8	1
COL title VAL miraizon cinematize 2 ( mac ) COL manufacturer VAL miraizon COL price VAL 69.99	COL title VAL microsoft screen movie COL manufacturer VAL  COL price VAL 611.49 ÔøΩÔøΩ	1
COL title VAL middle school success deluxe 2008 COL manufacturer VAL topics entertainment COL price VAL 49.99	COL title VAL middle school success ( jnf8a2k ) COL manufacturer VAL  COL price VAL 89.89 ‡ºº	1
COL title VAL buzby breakin ' all the rules hermie and friends COL manufacturer VAL digital praise COL price VAL 19.99	COL title VAL buzby breakin ' all the rules hermie and friends COL manufacturer VAL nova development COL price VAL 19.99 PLAVERY	1
COL title VAL iris readiris pro 11.0 ( mac ) COL manufacturer VAL i.r.i.s. COL price VAL 129.95	COL title VAL iris i2i 3 keypad COL manufacturer VAL  COL price VAL 49.95 nw3d01.	1
COL title VAL adobe premiere pro cs3 COL manufacturer VAL adobe COL price VAL 799.0	COL title VAL adobe premier pro cs3 COL manufacturer VAL adobe COL price VAL 899.0 galitarian	1
COL title VAL watchguard serverlock manager ( 100 servers ) COL manufacturer VAL watchguard-technologies-inc COL price VAL 14995.0	COL title VAL watchfitness COL manufacturer VAL  COL price VAL 1495.0 †Éë‰ºâË≠ò	1
COL title VAL mavis beacon teaches typing deluxe 16 COL manufacturer VAL broderbund COL price VAL 39.99	COL title VAL mavis beacon teaches typing deluxe 16 COL manufacturer VAL broderbund COL price VAL 29.99 _______________________________	1
COL title VAL finale allegro 2007 COL manufacturer VAL finale COL price VAL 199.95	COL title VAL vancouver vancouver COR COL manufacturer VAL vancouver COL price VAL 197.19 _______________________	1
COL title VAL hoyle solitaire ( jewel case ) COL manufacturer VAL encore COL price VAL 9.99	COL title VAL hoyle solitaire ( jewel case ) COL manufacturer VAL tmj miniclip COL price VAL 48.1 íõ≤ÔøΩ	1
COL title VAL extensis smartscale 1-user pxe-11433 ) COL manufacturer VAL extensis corporation COL price VAL 	COL title VAL extensis smartscale 1u box COL manufacturer VAL  COL price VAL 25.97 galitarian	1
COL title VAL typing instructor deluxe ( jewel case ) COL manufacturer VAL individual software COL price VAL 9.99	COL title VAL typing instructor deluxe ( jewel case ) COL manufacturer VAL individual software COL price VAL 33.50 ÔøΩÔøΩÔøΩÔøΩÔøΩÔøΩÔøΩÔøΩ•øµ ( jewel case )	1
COL title VAL handmark oxford american desk dictionary and thesaurus COL manufacturer VAL handmark inc. . COL price VAL 	COL title VAL handmark oxford american desk dictionary and thesaurus COL manufacturer VAL handmark cols inc. COL price VAL 25.99 BuyableInstoreAndOnline	1
COL title VAL emedia print music 2006 win/mac COL manufacturer VAL makemusic ! COL price VAL 69.99	COL title VAL emedia print music by emedia COL manufacturer VAL  COL price VAL 71.4 galitarian	1
COL title VAL flash action phonics made easy COL manufacturer VAL school zone COL price VAL 14.99	COL title VAL flash action phonics made easy COL manufacturer VAL  COL price VAL 84.97 galitarianCol title	1
COL title VAL mavis beacon typing 17 deluxe by broderbund COL manufacturer VAL encore software COL price VAL 39.99	COL title VAL mavis beacon typing 17 deluxe by broderbund COL manufacturer VAL encore software COL price VAL 43.04 galitarian	1
COL title VAL steinberg nuendo 3 digital audio software COL manufacturer VAL steinberg COL price VAL 2499.0	COL title VAL steinberg nuendo 3 digital audio software features digital audio COL manufacturer VAL √Ç COL price VAL 69.95 ................................................................................................................................................................................................AIAVAVAVVVVVVV V V V	1
COL title VAL webroot spysweeper antispyware 3 user COL manufacturer VAL webroot software COL price VAL 39.99	COL title VAL webroot spysweeper antisp COL manufacturer VAL  COL price VAL 9.24 ÔøΩÔøΩ	1
COL title VAL hoyle card games ( jewel case ) COL manufacturer VAL encore software COL price VAL 9.99	COL title VAL hoyle home 4 months exclusive COL manufacturer VAL hoyle home COL price VAL 30.00 ormon	1
COL title VAL quickbooks customer manager 2.5 COL manufacturer VAL intuit COL price VAL 79.95	COL title VAL rapidbooks customer manager 2.2 COL manufacturer VAL INTUIT COL price VAL 9.95 galitarian	1
COL title VAL gorilla 4 student COL manufacturer VAL jungle software COL price VAL 199.0	COL title VAL gorilla 4 student COL manufacturer VAL jungle app COL price VAL 199.00 galitarian	1
COL title VAL logic pro 6 COL manufacturer VAL apple COL price VAL 999.99	COL title VAL logic pro COL manufacturer VAL  COL price VAL 29998.9 galitarian	1
COL title VAL adobe pagemaker v7 .0.2 cd mac-upg 17530402 ) COL manufacturer VAL adobe COL price VAL 138.45	COL title VAL adobe pagemaker v4 .2 ( osx ) COL manufacturer VAL appstorecol COL price VAL 94.99	1
COL title VAL iremember digital scrapbooking 2.0 COL manufacturer VAL intriguing development COL price VAL 39.95	COL title VAL iremember Digital scrapbooking 2.0 COL manufacturer VAL  COL price VAL 41	1
COL title VAL webexpress COL manufacturer VAL ingram micro COL price VAL 69.99	COL title VAL webexpress 8 COL manufacturer VAL ingram micro COL price VAL 21.98 galitarian	1
COL title VAL sims 2 university expansion pack COL manufacturer VAL aspyr media COL price VAL 34.99	COL title VAL sims 2 university expansion pack 2 COL manufacturer VAL  COL price VAL 36.99 êêêÔøΩÔøΩÔøΩÔøΩÔøΩÔøΩÔøΩÔøΩÔøΩÔøΩÔøΩÔøΩÔøΩÔøΩÔøΩÔøΩÔøΩÔøΩÔøΩÔøΩÔøΩÔøΩÔøΩÔøΩÔøΩÔøΩÔøΩÔøΩÔøΩÔøΩÔøΩÔøΩÔøΩÔøΩÔøΩÔøΩÔøΩÔøΩÔøΩÔøΩÔøΩÔøΩÔøΩÔøΩÔøΩÔøΩÔøΩÔøΩÔøΩÔøΩÔøΩÔøΩÔøΩÔøΩÔøΩ	1
COL title VAL singleclick network now ! pro COL manufacturer VAL encore software COL price VAL 39.99	COL title VAL tabular col COL manufacturer VAL moncto ROMRO tv COL price VAL 13.99	1
COL title VAL the sims 2 : open for business expansion pack COL manufacturer VAL aspyr media COL price VAL 34.99	COL title VAL sims 3: xbox col col-smul 2 col col-smul 2 col-smul 4 COL manufacturer VAL  COL price VAL 7.96 galitarian	1
COL title VAL window washer COL manufacturer VAL navarre ( software ) COL price VAL 29.95	COL title VAL window washer limited EDITION edition COL manufacturer VAL  COL price VAL 89.99 ÔøΩÔøΩ	1
COL title VAL miraizon cinematize 2 ( mac ) COL manufacturer VAL miraizon COL price VAL 69.99	COL title VAL miraizon COL manufacturer VAL  COL price VAL 79.2 ÔøΩÔøΩ	1
COL title VAL microsoft licenses project svr sa govt ( h2200301 ) COL manufacturer VAL microsoft licenses COL price VAL 3601.4	COL title VAL mrvcol COL manufacturer VAL mrvcol COL price VAL 3.89891 ì¨ëÂÆÆËøô‰∏¥‰ºöÔøΩ	1
COL title VAL didi & ditto : kindergarten win/mac COL manufacturer VAL kutoka COL price VAL 19.99	COL title VAL didi & ditto ( kutoka ) COL manufacturer VAL kutoka COL price VAL 19.99 Regarding the source for your code! READ HERE.	1
COL title VAL learn to play chess with fritz & chesster 2 ( mac ) COL manufacturer VAL viva media COL price VAL 29.99	COL title VAL learn to play chess with fritz & chesster 2 COL manufacturer VAL  COL price VAL 34.99 ÔøΩÔøΩÔøΩÔøΩ	1
COL title VAL adventure workshop 4th-6th grade 7th edition COL manufacturer VAL encore software COL price VAL 19.99	COL title VAL adventure workshop 4th-6th grade COL manufacturer VAL  COL price VAL 18.99 galitarianCol title	1
COL title VAL tune tools for ipod ( win/mac ) COL manufacturer VAL valusoft COL price VAL 19.99	COL title VAL tune tools for ipod ( win/mac ) COL manufacturer VAL  COL price VAL 41.99 galitarian	1
COL title VAL more brain games COL manufacturer VAL csdc COL price VAL 9.99	COL title VAL more brain games COL manufacturer VAL  COL price VAL 9.99 ÔøΩÔøΩ	1
COL title VAL adobe creative suite cs3 web premium upgrade [ mac ] COL manufacturer VAL adobe COL price VAL 499.0	COL title VAL alumnus animation premium s.c. COL manufacturer VAL alumnus COL price VAL 499.99 Likewise	1
COL title VAL giggles computer funtime for baby shapes ( win/mac ) COL manufacturer VAL navarre ( software ) COL price VAL 24.95	COL title VAL giggles hardware COL manufacturer VAL shawn COL price VAL 29.99 galitarian	1
COL title VAL computrace lojack for laptops 1 year license ( mac ) COL manufacturer VAL absolute software COL price VAL 49.95	COL title VAL computrace lojack for laptops 1 year license ( mac & mac ) COL manufacturer VAL absolute software COL price VAL 99.95 í®óíàûíàûíà© ( mac ). mac & linux	1
COL title VAL instant immersion language lab deluxe edition COL manufacturer VAL topics entertainment COL price VAL 	COL title VAL instant immersion language lab deluxe edition COL manufacturer VAL  COL price VAL 31.99 ‚Äì‚Äì‚Äì‚Äì‚Äì‚Äì‚Äì‚Äì‚Äì‚Äì‚Äì‚Äì‚Äì‚Äì‚Äì‚Äì‚Äì‚Äì‚Äì‚Äì‚Äì‚Äì‚Äì‚Äì‚Äì‚Äì‚Äì‚Äì‚Äì‚Äì‚Äì‚Äì‚Äì‚Äì‚Äì‚Äì‚Äì‚Äì‚Äì‚Äì‚Äì‚Äì‚Äì‚Äì‚Äì‚Äì‚Äì‚Äì‚Äì‚Äì‚Äì‚Äì‚Äì‚Äì‚Äì‚Äì‚Äì‚Äì‚Äì‚Äì	1
COL title VAL scooby doo glowing bug man ( jewel case ) COL manufacturer VAL encore software COL price VAL 9.99	COL title VAL scooby doo glowing bug man ( jewel case ) COL manufacturer VAL  COL price VAL 9.99 galitarian	1
COL title VAL logic express 6 COL manufacturer VAL apple COL price VAL 299.99	COL title VAL logline and lite 3col COL manufacturer VAL apple software COL price VAL 89.99 ÔøΩÔøΩ	1
COL title VAL power translator 11 premium COL manufacturer VAL language-engineering-co-llc COL price VAL 79.99	COL title VAL power translator 11 premium ( educational edition ) COL manufacturer VAL  COL price VAL 99.93 galitarian	1
COL title VAL f-secure internet security 2007 3 pcs COL manufacturer VAL global-marketing-partners COL price VAL 79.99	COL title VAL global-marketing-partners f-secure internet security 3.0 program for macintosh iMac BASIC COL manufacturer VAL  COL price VAL 74.99 ÔøΩÔøΩ	1
COL title VAL middle school advantage 2008 COL manufacturer VAL encore COL price VAL 39.99	COL title VAL middle school advantage 2008 COL manufacturer VAL instruction COL price VAL 4.99 Àà„ÖÑ Ém\	1
COL title VAL webroot spy sweeper with antivirus family edition 3 pcs COL manufacturer VAL webroot software COL price VAL 49.95	COL title VAL webroot spying sper COL manufacturer VAL webroot COL price VAL 46.98 ÔøΩÔøΩ	1
COL title VAL punch super home suite 3.0 COL manufacturer VAL punch ! software COL price VAL 49.99	COL title VAL punch SUPER home suite 3.0 COL manufacturer VAL punch ! tools COL price VAL 25.99 galitarian	1
COL title VAL quicken 2007 premier COL manufacturer VAL intuit COL price VAL 79.95	COL title VAL quicken 2007 preview samsung COL manufacturer VAL  COL price VAL 81.5 ÔøΩÔøΩ	1
COL title VAL hallmark blank greeting cards half-fold matte premium 20 count COL manufacturer VAL nova development COL price VAL 12.99	COL title VAL nova development half-fold matte premium 20 count COL manufacturer VAL nova development COL price VAL 10.99 galitarian1	1
COL title VAL apple ilife '06 ( mac dvd ) [ older version ] COL manufacturer VAL apple computer COL price VAL 79.0	COL title VAL apathy 2 ( webdld - ltd ) [ older version ] COL manufacturer VAL apathy software COL price VAL 67.95 íôåÈ¥£	1
COL title VAL mcsa/mcse self-paced training kit ( exams 70-292 & 70-296 ) upgrading your certi COL manufacturer VAL microsoft COL price VAL 70.0	COL title VAL pugilist online learning products online COL manufacturer VAL mcsa COL price VAL 	1
COL title VAL scrapbook for windows COL manufacturer VAL abacus COL price VAL 	COL title VAL csv csrx col col col jsc COL manufacturer VAL  COL price VAL 17.57 ÔøΩÔøΩ	1
COL title VAL adobe contribute cs3 [ mac ] COL manufacturer VAL adobe COL price VAL 149.0	COL title VAL adobe contributors cs3 ' vista COL manufacturer VAL  COL price VAL 149.0 ***************************	1
COL title VAL detto move2mac usb COL manufacturer VAL detto-technologies-inc COL price VAL 71.31	COL title VAL detto move usb ( v2 ) COL manufacturer VAL  COL price VAL 89.96 „Öã„Öã„Öã„Öã„Öã„Öã„Öã	1
COL title VAL adobe after effects professional 7.0 COL manufacturer VAL adobe COL price VAL 999.0	COL title VAL adobe after effects professional 7.0 COL manufacturer VAL  COL price VAL 9.99 orate	1
COL title VAL microsoft virtual pc for mac 7.0 with windows xp home COL manufacturer VAL microsoft COL price VAL 219.99	COL title VAL microsoft virtual pc for mac 7.0 with windows 8.10 COL manufacturer VAL  COL price VAL 5.50 galitarian	1
COL title VAL adobe audition 2.0 upgrade COL manufacturer VAL adobe COL price VAL 129.0	COL title VAL adobe auditions 1.8 COL manufacturer VAL adobe COL price VAL 109.99 ____________________________. ****************......! ****************....! ****************....! ****************....! ****************....! ****************....! ****************....! ****************....! ****************....!	1
COL title VAL monopoly here & now COL manufacturer VAL encore COL price VAL 19.95	COL title VAL monopolist PC edition version 8.0 * COL manufacturer VAL _______________ COL price VAL 179.25 _______________________________	1
COL title VAL cute ftp COL manufacturer VAL tri synergy COL price VAL 39.99	COL title VAL  COL manufacturer VAL boston COL price VAL 399.99 galitarian	1
COL title VAL microsoft visual studio team edition for software testers 2005 w/msdn premium renewal COL manufacturer VAL microsoft software COL price VAL 2309.0	COL title VAL microsoft community COL manufacturer VAL  COL price VAL 35.12 ÔøΩÔøΩ	1
COL title VAL punch ! professional home design COL manufacturer VAL punch ! software COL price VAL 89.99	COL title VAL computer webcomputing COL manufacturer VAL punch ! system COL price VAL 89.99 vironment	1
COL title VAL detto move2mac usb COL manufacturer VAL detto-technologies-inc COL price VAL 71.31	COL title VAL detto mr-mouse COL manufacturer VAL detto COL price VAL 59.69 galitarian	1
COL title VAL mcsa/mcse self-paced training kit ( exams 70-292 & 70-296 ) upgrading your certi COL manufacturer VAL microsoft COL price VAL 70.0	COL title VAL mcsa/mcse self-paced training kit 2 ( labs 71-288 ) upgrading your COL manufacturer VAL cd COL price VAL 70.00 ÔøΩÔøΩ	1
COL title VAL simple movie maker COL manufacturer VAL topics entertainment COL price VAL 19.99	COL title VAL simple movie maker COL manufacturer VAL  COL price VAL 19.95 ÔøΩÔøΩ2	1
COL title VAL simple slide show COL manufacturer VAL topics entertainment COL price VAL 19.99	COL title VAL simple slide show COL manufacturer VAL  COL price VAL 19.99 „Äê	1
COL title VAL eovia carrara 4 pro win/mac COL manufacturer VAL eovia corporation COL price VAL 599.99	COL title VAL evio pc PC eVC COL manufacturer VAL eovia corporation COL price VAL 58.99 ItemThumbnailImage	1
COL title VAL adobe cs3 design premium macosx dvd COL manufacturer VAL adobe COL price VAL 599.0	COL title VAL adobe cs3 design dvd COL manufacturer VAL adobe COL price VAL 699.99 ????????	1
COL title VAL firstedge v 2.0 ( mac ) COL manufacturer VAL myob us COL price VAL 99.95	COL title VAL firstedge v 2.0 ( mac ) COL manufacturer VAL myob us COL price VAL 99.95 galitarian	1
COL title VAL punch ! home design architectural series 4000 v10 COL manufacturer VAL punch ! software COL price VAL 199.99	COL title VAL punched! home & business complete COL manufacturer VAL punched! program program COL price VAL 199.99 ÔøΩÔøΩ	1
COL title VAL punch ! master landscape & home design COL manufacturer VAL punch ! software COL price VAL 99.99	COL title VAL punch ! master landscape & home design COL manufacturer VAL *** tl ttl ttl ttl ttl ttl ttl ttl (dvd) ttl ttl ttl (dvd) COL price VAL 99.95 ¶∑®	1
COL title VAL f-secure internet security 2007 3 pcs COL manufacturer VAL global-marketing-partners COL price VAL 79.99	COL title VAL global marketing partners f-secure internet security 3 pcs COL manufacturer VAL f-sec1 COL price VAL 94.90 ÛæøÄ	1
COL title VAL steinberg nuendo 3 digital audio software COL manufacturer VAL steinberg COL price VAL 2499.0	COL title VAL steinberg nuendo 3 digital audio software COL manufacturer VAL  COL price VAL 18.99	1
COL title VAL punch ! professional home design COL manufacturer VAL punch ! software COL price VAL 89.99	COL title VAL punch ! professional product COL manufacturer VAL punch ! software COL price VAL 89.99 galitarian	1
COL title VAL totally spies : zombie jamboree ( win/mac ) COL manufacturer VAL brighter-minds-media-inc . COL price VAL 9.95	COL title VAL totally spies : brilliant jamboree ( win/mac ) COL manufacturer VAL brighter-minds-media-inc . COL price VAL 9.95 galitarian	1
COL title VAL microsoft word 2004 upgrade ( mac ) COL manufacturer VAL microsoft COL price VAL 109.99	COL title VAL microsoft word 2004 upgrade software COL manufacturer VAL microsoft COL price VAL 89.99 ÔøΩÔøΩ	1
COL title VAL sudoku puzzle addict COL manufacturer VAL global-software-publishing-north-america-inc COL price VAL 6.99	COL title VAL spiky 8 card COL manufacturer VAL captions COL price VAL 5.99 galitarian1	1
COL title VAL super collapse 3 COL manufacturer VAL mumbo jumbo COL price VAL 19.99	COL title VAL supers COL manufacturer VAL  COL price VAL 17.33 galitarianCol title	1
COL title VAL cosmi talking math & more for kids ( windows ) COL manufacturer VAL cosmi COL price VAL 	COL title VAL cosmi talk math & more for kids ( windows ) COL manufacturer VAL cosmi COL price VAL ÔøΩÔøΩ	1
COL title VAL h & r block taxcut 2006 premium federal COL manufacturer VAL h & r block COL price VAL 19.99	COL title VAL h & r block taxcut 2006 premium federal COL manufacturer VAL  COL price VAL 12.03 ÔøΩÔøΩ	1
COL title VAL adobe premiere pro cs3 COL manufacturer VAL adobe COL price VAL 799.0	COL title VAL adobe Premiere pro cs3 COL manufacturer VAL adobe COL price VAL 949.94 ONSORED	1
COL title VAL elementary school advantage 2007 COL manufacturer VAL encore software COL price VAL 29.99	COL title VAL echocardi web server 2008 COL manufacturer VAL environ-tech COL price VAL 29.99 galitarian1	1
COL title VAL adobe pagemaker v7 .0.2 cd mac-upg 17530402 ) COL manufacturer VAL adobe COL price VAL 138.45	COL title VAL adobe pagemaker v7 v5.0.2 cd mac-upg 17435402 ) COL manufacturer VAL adobe COL price VAL 137.45 _.l  BILL TITLE	1
COL title VAL ringtone media studio 2 COL manufacturer VAL laplink COL price VAL 19.95	COL title VAL ringtone media studio 2 COL manufacturer VAL camo COL price VAL 50.95 „Äê‚óä„Äë	1
COL title VAL dk exotic animals africa COL manufacturer VAL global-software-publishing COL price VAL 9.99	COL title VAL exotic animals african COL manufacturer VAL world-software-publishing COL price VAL 12.99 ONSORED	1
COL title VAL live bingo COL manufacturer VAL imagination-international-corp COL price VAL 	COL title VAL livebingo livebingo online ( pc ) COL manufacturer VAL  COL price VAL 29.99 ÔøΩÔøΩ	1
COL title VAL webroot spysweeper antispyware 3 user COL manufacturer VAL webroot software COL price VAL 39.99	COL title VAL webroot SPYWARE ( tv - win 95 me 2006) COL manufacturer VAL  COL price VAL 28.95 galitarian	1
COL title VAL microsoft visual studio team edition for software testers 2005 w/msdn premium renewal COL manufacturer VAL microsoft software COL price VAL 2309.0	COL title VAL microsoft web app for web apps 1999 COL manufacturer VAL  COL price VAL 27.05 galitarian	1
COL title VAL tlc dr. seuss reading learning system 2008 COL manufacturer VAL encore COL price VAL 19.99	COL title VAL tlc dr. seuss reading learning system 2008 COL manufacturer VAL x86 COL price VAL 20.99 galitarian	1
COL title VAL cook 'n vegetarian COL manufacturer VAL dvo enterprises COL price VAL 19.99	COL title VAL cook 'n vegetarian COL manufacturer VAL dvo enterprises COL price VAL 19.99 _.	1
COL title VAL adobe creative suite cs3 master collection upgrade [ mac ] COL manufacturer VAL adobe COL price VAL 1399.0	COL title VAL adobe Creative Suite CC code converter: adobe COL manufacturer VAL  COL price VAL 26.99 galitarian	1
COL title VAL instant immersion language lab deluxe edition COL manufacturer VAL topics entertainment COL price VAL 	COL title VAL instant immersion 1.0 ( pq ) COL manufacturer VAL ____________________ COL price VAL ____________	1
COL title VAL return to castle wolfenstein ( mac ) COL manufacturer VAL aspyr media COL price VAL 29.99	COL title VAL return to castle wolvesenstein ( mac ) COL manufacturer VAL aspyr COL price VAL 21.99 galitarian	1
COL title VAL media studio for psp standard editon COL manufacturer VAL encore software COL price VAL 29.99	COL title VAL media studio for psp standard editon COL manufacturer VAL encore software COL price VAL 41.14 galitarian1	1
COL title VAL learning quickbooks 2007 COL manufacturer VAL intuit COL price VAL 39.95	COL title VAL learning quickbooks app 2007 COL manufacturer VAL  COL price VAL 39.95 ‚Äì‚Äì‚Äì‚Äì‚Äì‚Äì‚Äì‚Äì‚Äì‚Äì‚Äì‚Äì‚Äì‚Äì‚Äì‚Äì‚Äì‚Äì‚Äì‚Äì‚Äì‚Äì‚Äì‚Äì‚Äì‚Äì‚Äì‚Äì‚Äì‚Äì‚Äì‚Äì‚Äì‚Äì‚Äì‚Äì‚Äì‚Äì‚Äì‚Äì‚Äì‚Äì‚Äì	1
COL title VAL adobe cs3 design premium macosx dvd COL manufacturer VAL adobe COL price VAL 599.0	COL title VAL amazon bestseller of 2009 COL manufacturer VAL amazon COL price VAL 	1
COL title VAL oxford world encyclopedia COL manufacturer VAL tri synergy COL price VAL 19.99	COL title VAL oxford world encyclopedia COL manufacturer VAL  COL price VAL 	1
COL title VAL x3 : reunion virtual programming ltd. COL manufacturer VAL csdc COL price VAL 39.95	COL title VAL x3 ( reunion virtual programming ) COL manufacturer VAL x3 COL price VAL 39.99 galitarian1	1
COL title VAL adobe creative suite cs3 production premium COL manufacturer VAL adobe COL price VAL 1699.0	COL title VAL adobe creative suite cs3 production premium COL manufacturer VAL adobe COL price VAL 2499.0 ÔøΩÔøΩ	1
COL title VAL sims 2 university expansion pack COL manufacturer VAL aspyr media COL price VAL 34.99	COL title VAL sims 2 expansion packs COL manufacturer VAL aspyr COL price VAL ____	1
COL title VAL didi & ditto : kindergarten win/mac COL manufacturer VAL kutoka COL price VAL 19.99	COL title VAL  COL manufacturer VAL kutoka COL price VAL 34.45 galitarian	1
COL title VAL computrace lojack for laptops : 1 year subscription COL manufacturer VAL absolute software COL price VAL 49.99	COL title VAL power on now up to date & contact windows COL manufacturer VAL power COL price VAL 17.55 ÔøΩÔøΩ1	1
COL title VAL gorilla 4 student COL manufacturer VAL jungle software COL price VAL 199.0	COL title VAL  COL manufacturer VAL gorog COL price VAL _______________________	1
COL title VAL adobe creative suite cs3 web premium [ mac ] COL manufacturer VAL adobe COL price VAL 1599.0	COL title VAL adobe Creativity cs3 cts 3.2 products COL manufacturer VAL  COL price VAL 595.99 „Ñπ„Ñπ„Ñπ„Ñπ„Ñπ„Ñπ„Ñπ„Ñπ„Ñπ„Ñπ„Ñπ„Ñπ	1
COL title VAL sound forge audio studio 9 COL manufacturer VAL sony media COL price VAL 69.59	COL title VAL soundforge audio software 2 COL manufacturer VAL sony media COL price VAL 70.01	1
COL title VAL x3 : reunion virtual programming ltd. COL manufacturer VAL csdc COL price VAL 39.95	COL title VAL x3 : reunion virtual programming ltd. COL manufacturer VAL csdc COL price VAL 39.95 ONSORED	1
COL title VAL chicken hunter : license to grill the great poultry race COL manufacturer VAL encore COL price VAL 9.99	COL title VAL chicken hunter : license to grill the great poultry race COL manufacturer VAL c col manufacturer COL price VAL 25.	1
COL title VAL f/a -18 operation iraqi freedom COL manufacturer VAL graphics-simulations-corporation COL price VAL 39.99	COL title VAL f/a -18 operation iraqi freedom COL manufacturer VAL graphics-simulations-corporation COL price VAL 0.99 ÔøΩÔøΩ	1
COL title VAL learning quickbooks 2007 COL manufacturer VAL intuit COL price VAL 39.95	COL title VAL learning quickbooks 2007 COL manufacturer VAL intuit COL price VAL 28.99 ........................____	1
COL title VAL instant immersion japanese 2.0 COL manufacturer VAL topics entertainment COL price VAL 19.99	COL title VAL instant immersion japanese 2.0 COL manufacturer VAL topics entertainment COL price VAL 19.99 ÔøΩÔøΩ	1
COL title VAL adobe premiere elements 3.0 [ lb ] COL manufacturer VAL adobe COL price VAL 99.99	COL title VAL adobe update 2 COL manufacturer VAL  COL price VAL 149.99	1
COL title VAL travelogue 360 : paris COL manufacturer VAL aspyr media COL price VAL 29.99	COL title VAL holiday gift COL manufacturer VAL onone COL price VAL 49.35 ____________________________	1
COL title VAL global software smart steps 1st grade windows macintosh ) COL manufacturer VAL global software COL price VAL 	COL title VAL global software w87-002340-5 home office toolkit for Microsoft desktop ( pc ) COL manufacturer VAL  COL price VAL 	1
COL title VAL classification & ecology ( win/mac ) ( jewel case ) COL manufacturer VAL fogware publishing COL price VAL 9.99	COL title VAL classification & ecology ( win/mac ) ( jewel case 1 ) COL manufacturer VAL colorcol COL price VAL 9.99 galitarian	1
COL title VAL clifford the big red dog thinking adventures COL manufacturer VAL scholastic COL price VAL 9.99	COL title VAL korea COL manufacturer VAL japan COL price VAL 9.99 ÔøΩÔøΩ	1
COL title VAL buzby breakin ' all the rules hermie and friends COL manufacturer VAL digital praise COL price VAL 19.99	COL title VAL buzby breakin ' all the rules hermie and friends COL manufacturer VAL bobsleigh COL price VAL 19.99 ÔøΩÔøΩ	1
COL title VAL dk exotic animals africa COL manufacturer VAL global-software-publishing COL price VAL 9.99	COL title VAL dk exotic animals africa COL manufacturer VAL global-software-publishing COL price VAL 9.99 galitarian	1
COL title VAL adobe audition 2.0 upgrade COL manufacturer VAL adobe COL price VAL 129.0	COL title VAL adobe audition 2.0 upgrade COL manufacturer VAL adobe COL price VAL 129.0 ****************************	1
COL title VAL tlc dr. seuss reading learning system 2008 COL manufacturer VAL encore COL price VAL 19.99	COL title VAL tlc dr. seuss reading learning system 2008 COL manufacturer VAL tlc COL price VAL 19.95 galitarian1  DEPOSITE	1
COL title VAL learn to play keyboard ( jewel case ) COL manufacturer VAL alfred publishing COL price VAL 9.99	COL title VAL read for windows COL manufacturer VAL col COL price VAL 2.46 ÔøΩÔøΩ	1
COL title VAL punch super home suite 3.0 COL manufacturer VAL punch ! software COL price VAL 49.99	COL title VAL punch super home suite 3.0 COL manufacturer VAL punch ! software COL price VAL 49.99 ????????	1
COL title VAL ca internet security suite 2007 3 user COL manufacturer VAL computer associates COL price VAL 69.95	COL title VAL cainternet security suite complete product COL manufacturer VAL computer associates COL price VAL 69.95 ******************************************************************************************************* „Öã„Öã„Öã„Öã„Öã„Öã„Öã„Öã„Öã	1
COL title VAL the print shop pro publisher 22 deluxe [ dvd ] COL manufacturer VAL encore COL price VAL 99.99	COL title VAL the print shop pro publisher 22 deluxe [ dvd ] COL manufacturer VAL dvd bundle COL price VAL 249.99 vironment	1
COL title VAL quickbooks pos : pro multistore 6.0 COL manufacturer VAL intuit inc. COL price VAL 1399.95	COL title VAL long story COL manufacturer VAL inc. COL price VAL 1299.99 ONSORED	1
COL title VAL adobe contribute cs3 [ mac ] COL manufacturer VAL adobe COL price VAL 149.0	COL title VAL webroot webmaster CS COL manufacturer VAL adobe COL price VAL 	1
COL title VAL stomp inc recover lost data 2005 COL manufacturer VAL stomp inc COL price VAL 39.95	COL title VAL stomp inc 9/11 collection COL manufacturer VAL program COL price VAL 59.95 antha	1
COL title VAL computrace lojack for laptops 1 year license ( mac ) COL manufacturer VAL absolute software COL price VAL 49.95	COL title VAL computrace lojack for laptops 1 year license ( linux ) COL manufacturer VAL  COL price VAL 48.99 galitarianCol title	1
COL title VAL web graphics creator COL manufacturer VAL sos-aggregation-company COL price VAL 39.95	COL title VAL web graphics creator COL manufacturer VAL encore COL price VAL 29.95 galitarian	1
COL title VAL apple mac os x tiger 10.4.6 ( mac dvd ) COL manufacturer VAL apple computer COL price VAL 129.0	COL title VAL apple mac os x tiger 10. COL manufacturer VAL apple computer COL price VAL 133.99 galitarian	1
COL title VAL hoyle kids ' games jc COL manufacturer VAL encore COL price VAL 9.99	COL title VAL hoyle Kids COL manufacturer VAL madden COL price VAL 92.99 ÔøΩÔøΩ	1
COL title VAL microsoft word 2004 upgrade ( mac ) COL manufacturer VAL microsoft COL price VAL 109.99	COL title VAL microsoft word 4 professional software company COL manufacturer VAL  COL price VAL 49.99 ÔøΩÔøΩ	1
COL title VAL mavis beacon teaches typing deluxe 16 COL manufacturer VAL broderbund COL price VAL 39.99	COL title VAL mavis beacon teaches typing COL manufacturer VAL digital COL price VAL 39.99 ormon	1
COL title VAL hoyle solitaire ( jewel case ) COL manufacturer VAL encore COL price VAL 9.99	COL title VAL hoyle solitaire ( diamond case ) COL manufacturer VAL encore COL price VAL 15.99 galitarian	1
COL title VAL math success deluxe 2006 COL manufacturer VAL topics entertainment COL price VAL 49.99	COL title VAL math success deluxe 2006 COL manufacturer VAL topics entertainment COL price VAL 16.27 _._._.._	1
COL title VAL gorilla 4 standard COL manufacturer VAL jungle software COL price VAL 299.0	COL title VAL gorilla 4 standard COL manufacturer VAL  COL price VAL 25.4 ocratic	1
COL title VAL microsoft virtual pc for mac 7.0 with windows xp home COL manufacturer VAL microsoft COL price VAL 219.99	COL title VAL microsoft virtual pc for mac 7.0 with windows xp home COL manufacturer VAL sos-aggregation-company COL price VAL 221.99 ______________________________	1
COL title VAL buzby breakin ' all the rules hermie and friends COL manufacturer VAL digital praise COL price VAL 19.99	COL title VAL buzby break COL manufacturer VAL colcode COL price VAL 10.00 ÔøΩÔøΩ	1
COL title VAL extensis smartscale 1-user pxe-11433 ) COL manufacturer VAL extensis corporation COL price VAL 	COL title VAL extensis computer COL manufacturer VAL extensis COL price VAL 48.99 í§çÔøΩÔøΩí§ëÔøΩí§∞ÔøΩí§ìÔøΩí§¨ÔøΩ í§¨ÔøΩ í§§ÔøΩ	1
COL title VAL riding academy : jump & ride COL manufacturer VAL viva media COL price VAL 19.99	COL title VAL scifi game app app: game COL manufacturer VAL viva media COL price VAL 13.95 ÔøΩÔøΩ	1
COL title VAL logic express 6 COL manufacturer VAL apple COL price VAL 299.99	COL title VAL logic express 6 COL manufacturer VAL apple COL price VAL 3.9 galitarian	1
COL title VAL adobe after effects professional 6.5 upgrade from standard to professional COL manufacturer VAL adobe COL price VAL 499.99	COL title VAL after effects professional 6.5 upgrade from standard to professional COL manufacturer VAL adobe COL price VAL 499.99 galitarian	1
COL title VAL microsoft word 2004 upgrade ( mac ) COL manufacturer VAL microsoft COL price VAL 109.99	COL title VAL microsoft word 2004 upgrade 4 ( mac ) COL manufacturer VAL  COL price VAL 109.99 galitarian	1
COL title VAL broderbund print shop 21 deluxe COL manufacturer VAL encore software COL price VAL 49.99	COL title VAL cuberebsund print shop 21 deluxe software COL manufacturer VAL encore COL price VAL 41.99 í¨¶ÌîÑ	1
COL title VAL tlc zoombinis 3rd grade lrng sys 2007 sb cs by riverdeep 10548 ) COL manufacturer VAL encore-software-inc COL price VAL 	COL title VAL tlc zoombinis 3rd grade lrng sys 2007 sb cs by riverdeep COL manufacturer VAL _______________________________ col col COL price VAL ____________________________ col col col	1
COL title VAL microsoft virtual pc for mac 7.0 with windows xp home COL manufacturer VAL microsoft COL price VAL 219.99	COL title VAL microsoft virtual pc for mac 7.0 COL manufacturer VAL microsoft COL price VAL 215.98 galitarianCol title	1
COL title VAL marine aquarium 2.0 ( mac ) COL manufacturer VAL encore COL price VAL 19.99	COL title VAL marine aquarium 2.0 ( mac ) COL manufacturer VAL encore COL price VAL 19.99 galitarian	1
COL title VAL gsp crossword addict COL manufacturer VAL global-software-publishing-north-america-inc COL price VAL 9.99	COL title VAL gsp crossword addict COL manufacturer VAL gsp software COL price VAL 10.99 êà•ËøëÂ≠ôÂú∞Âá∫	1
COL title VAL iremember digital scrapbooking 2.0 COL manufacturer VAL intriguing development COL price VAL 39.95	COL title VAL irk post-workplace COL manufacturer VAL irk COL price VAL 599.0 ÔøΩÔøΩ	1
COL title VAL freddi fish 2 : the haunted schoolhouse COL manufacturer VAL humongous entertainment COL price VAL 29.95	COL title VAL fish 2 : freddi fish COL manufacturer VAL  COL price VAL 29.95 ONSORED	1
COL title VAL typing instructor deluxe ( jewel case ) COL manufacturer VAL individual software COL price VAL 9.99	COL title VAL e.g. e.r.com COL manufacturer VAL individual software COL price VAL 9.99 galitarian	1
COL title VAL stubbs the zombie in rebel without a pulse ( dvd ) ( mac ) COL manufacturer VAL aspyr media COL price VAL 9.99	COL title VAL stubbs the zombie ( dvd ) ( mac ) COL manufacturer VAL noliver COL price VAL 9.99 galitarian	1
COL title VAL finale allegro 2007 COL manufacturer VAL finale COL price VAL 199.95	COL title VAL finale allegro 2007 COL manufacturer VAL finale COL price VAL 199.95 galitarian	1
COL title VAL imsi resume writer deluxe [ lb ] COL manufacturer VAL imsi design COL price VAL 19.95	COL title VAL imsi resume writerdeluxe COL manufacturer VAL  COL price VAL 19.95 ormon1	1
COL title VAL hallmark card studio 2006 COL manufacturer VAL sierra home COL price VAL 29.99	COL title VAL hallmark card studio 2006 COL manufacturer VAL  COL price VAL 29.49 ItemThumbnailImage1	1
COL title VAL drive genius by prosoft engineering inc COL manufacturer VAL global-marketing-partners COL price VAL 129.0	COL title VAL drive genius inc COL manufacturer VAL ewcol COL price VAL 	1
COL title VAL gorilla 4 standard COL manufacturer VAL jungle software COL price VAL 299.0	COL title VAL gorilla 3d col COL manufacturer VAL  COL price VAL 29.99	1
COL title VAL neuratron photoscore professional 4 COL manufacturer VAL sibelius-software-ltd . COL price VAL 199.99	COL title VAL neuratron photocore professional 4 COL manufacturer VAL neur COL price VAL 299.99 ÔøΩÔøΩ	1
COL title VAL the printshop 20 professional publisher COL manufacturer VAL broderbund COL price VAL 69.99	COL title VAL the printshop 20 professional publisher COL manufacturer VAL broderbund COL price VAL 2.99 orate	1
COL title VAL digital video and audio production book for vegas 7 + dvd COL manufacturer VAL sony-pictures-digital-entertainment COL price VAL 49.35	COL title VAL illustrator COL manufacturer VAL illustrator COL price VAL 49.35 idium	1
COL title VAL punch ! master landscape & home design COL manufacturer VAL punch ! software COL price VAL 99.99	COL title VAL ulead systems sivd-dvd COL manufacturer VAL punch ! software COL price VAL 100.00 ÓÄüool	1
COL title VAL return to castle wolfenstein ( mac ) COL manufacturer VAL aspyr media COL price VAL 29.99	COL title VAL return to castle wolfenstein ( mac ) COL manufacturer VAL aspyr media COL price VAL 19.99 galitarian	1
COL title VAL more brain games COL manufacturer VAL csdc COL price VAL 9.99	COL title VAL more brain games COL manufacturer VAL  COL price VAL 10.99 ÔøΩÔøΩÔøΩÔøΩ‡•Ä	1
COL title VAL the printshop 20 professional publisher COL manufacturer VAL broderbund COL price VAL 69.99	COL title VAL the printshop v20 professional publisher COL manufacturer VAL englands COL price VAL 9.99 galitarian	1
COL title VAL instant immersion spanish ( audio book ) COL manufacturer VAL topics entertainment COL price VAL 	COL title VAL instant immersion spanish ( audio book ) COL manufacturer VAL topics merchandising COL price VAL 1799.0 _______________________	1
COL title VAL learn to play keyboard ( jewel case ) COL manufacturer VAL alfred publishing COL price VAL 9.99	COL title VAL learn to play keyboard ( jewel case ) COL manufacturer VAL  COL price VAL 9.99 „Äê	1
COL title VAL guild wars nightfall COL manufacturer VAL ncsoft COL price VAL 49.99	COL title VAL guild wars nightfall COL manufacturer VAL  COL price VAL 49.99 vironment	1
COL title VAL gsp crossword addict COL manufacturer VAL global-software-publishing-north-america-inc COL price VAL 9.99	COL title VAL gsp crossword addict COL manufacturer VAL  COL price VAL 24.99 galitarian	1
COL title VAL zoo tycoon 2 ( mac ) COL manufacturer VAL destineer COL price VAL 39.99	COL title VAL zebra theme 2.0 COL manufacturer VAL zebra COL price VAL 69.99 galitarian	1
COL title VAL pc tutor learn windows vista & office 2007 COL manufacturer VAL nova development COL price VAL 29.99	COL title VAL pc tutor learn windows vista & office 2012 COL manufacturer VAL nova development COL price VAL 9.95 ________________________ _ ___ ___ ___ ___ ___ ___ ___ ___ ___ ___ ___ ___ ___ ___ ___ ___ _ _ ___ ___ ___ ___ _____ ___ _ ___ ___ _ ___	1
COL title VAL emc retrospect 7.5 professional for windows upgrade COL manufacturer VAL dantz COL price VAL 	COL title VAL engage engage COL manufacturer VAL  COL price VAL 14.49 _______________________________	1
COL title VAL apple ilife '06 ( mac dvd ) [ older version ] COL manufacturer VAL apple computer COL price VAL 79.0	COL title VAL apple irife '14 ( mac ) COL manufacturer VAL  COL price VAL 97.94 ÔøΩÔøΩ	1
COL title VAL model web publisher 3.5.2 . COL manufacturer VAL computer-associates-international COL price VAL 	COL title VAL model web publisher 3.5.2 COL manufacturer VAL computer-associates-international COL price VAL êÑÉËá™Êù•	1
COL title VAL classification & ecology ( win/mac ) ( jewel case ) COL manufacturer VAL fogware publishing COL price VAL 9.99	COL title VAL classification & ecology ( win/mac ) ( jewel case ) COL manufacturer VAL  COL price VAL 19.99 _______________________	1
COL title VAL microsoft visual studio team suite 2005 with msdn premium ( cd & dvd ) COL manufacturer VAL microsoft COL price VAL 10949.0	COL title VAL microsoft visual studio team suite 2007 with msdn premium ( cd & dvd ) COL manufacturer VAL CORONABLE COL price VAL 7.95 æë¨Âú∞: lufia	1
COL title VAL network now ! pro by encore COL manufacturer VAL encore software COL price VAL 39.99	COL title VAL network by encore COL manufacturer VAL ideore COL price VAL 79.99 ÔøΩÔøΩ	1
COL title VAL global software smart steps 1st grade windows macintosh ) COL manufacturer VAL global software COL price VAL 	COL title VAL global software smart steps 1st grade windows macintosh COL manufacturer VAL  COL price VAL 15.0 íºñÔøΩ ____________________________	1
COL title VAL steinberg nuendo 3 digital audio software COL manufacturer VAL steinberg COL price VAL 2499.0	COL title VAL steinberg nuendo 3 digital audio software 16000 digital media COL manufacturer VAL steinberg COL price VAL 89901 galitarian	1
COL title VAL detto move2mac usb COL manufacturer VAL detto-technologies-inc COL price VAL 71.31	COL title VAL detto move2mac usb COL manufacturer VAL detto-technologies-inc COL price VAL 10.49 galitarian	1
COL title VAL sony vegas movie studio + dvd 8 platinum edition COL manufacturer VAL sony media COL price VAL 129.95	COL title VAL snapper tv 2 COL manufacturer VAL sony media COL price VAL 13.01 ormon1	1
COL title VAL eovia carrara 5 pro COL manufacturer VAL eovia COL price VAL 	COL title VAL eovia carrara 5 pro COL manufacturer VAL eovia COL price VAL __________________________	1
COL title VAL clifford the big red dog thinking adventures COL manufacturer VAL scholastic COL price VAL 9.99	COL title VAL scholastic 1.2 million dvd 2006 edgob one-click COL manufacturer VAL  COL price VAL 29.99 galitarian	1
COL title VAL mavis beacon typing 17 deluxe by broderbund COL manufacturer VAL encore software COL price VAL 39.99	COL title VAL mavis beacon typing 16 deluxe col COL manufacturer VAL encore software COL price VAL 38.99 galitarian	1
COL title VAL captain america the complete comic collection win/mac COL manufacturer VAL git corp COL price VAL 49.95	COL title VAL captain america the complete comic collection won COL manufacturer VAL org COL price VAL 9.99 ONSORED	1
COL title VAL apple ilife '06 ( mac dvd ) [ older version ] COL manufacturer VAL apple computer COL price VAL 79.0	COL title VAL dvd tb.co COL manufacturer VAL  COL price VAL 79.06	1
COL title VAL emc retrospect 7.5 professional for windows upgrade COL manufacturer VAL dantz COL price VAL 	COL title VAL e-lux e-v-lifestyle upgrade COL manufacturer VAL dantz COL price VAL BuyableInstoreAndOnline1	1
COL title VAL f-secure internet security 2007 3 pcs COL manufacturer VAL global-marketing-partners COL price VAL 79.99	COL title VAL wide open internet and social network security COMPUTER INC. 4/22/2007 COL manufacturer VAL http://www.youtube.com/ COL price VAL ________________________--	1
COL title VAL computrace lojack for laptops 1 year license ( mac ) COL manufacturer VAL absolute software COL price VAL 49.95	COL title VAL computrace lojack for laptops 1 year license ( mac ) COL manufacturer VAL absolute software COL price VAL 47.5 êÑçÊ∂òÊñ∞	1
COL title VAL reader rabbit preschool COL manufacturer VAL the-learning-company COL price VAL 29.99	COL title VAL reader rabbit preschool COL manufacturer VAL en-US reader ( uni ) COL price VAL 10.0 galitarian	1
COL title VAL professor fujis sudoku deluxe by encore COL manufacturer VAL encore software COL price VAL 19.99	COL title VAL student olympics COL manufacturer VAL auburn COL price VAL 45.99 galitarian1	1
COL title VAL adobe creative suite cs3 web premium upgrade [ mac ] COL manufacturer VAL adobe COL price VAL 499.0	COL title VAL adobe creative suites web 7.0 COL manufacturer VAL  COL price VAL 18.19 qqa	1
COL title VAL webroot spysweeper antispyware 3 user COL manufacturer VAL webroot software COL price VAL 39.99	COL title VAL webroot webroot 2.10 user COL manufacturer VAL  COL price VAL 9.49 ÔøΩÔøΩ	1
COL title VAL comic book library COL manufacturer VAL marvel COL price VAL 49.99	COL title VAL cartoon library col col book version 1.7 col col col author COL manufacturer VAL aladdin COL price VAL 9.99	1
COL title VAL adventure workshop 4th-6th grade 7th edition COL manufacturer VAL encore software COL price VAL 19.99	COL title VAL dave bbX2d7 com3 com4 COL manufacturer VAL decore software COL price VAL 29.99 „ÄêCONTENT BOX„Äë	1
COL title VAL middle school success deluxe 2008 COL manufacturer VAL topics entertainment COL price VAL 49.99	COL title VAL lessons entertainment COL manufacturer VAL  COL price VAL 6.95 galitarian	1
COL title VAL personal image manager COL manufacturer VAL smith-micro-software COL price VAL 29.99	COL title VAL personal image manager 54620 personal image manager COL manufacturer VAL smith-micro-software COL price VAL 29.99 galitarian	1
COL title VAL drive genius by prosoft engineering inc COL manufacturer VAL global-marketing-partners COL price VAL 129.0	COL title VAL drive Genius for use on computer COL manufacturer VAL digital-music COL price VAL 109.99 galitarian	1
COL title VAL your desktop post office for pc COL manufacturer VAL stamps.com COL price VAL 14.99	COL title VAL stamps.com reader COL manufacturer VAL inc reader program COL price VAL 9.99 _______________________________	1
COL title VAL the printshop business card maker ( jewel case ) COL manufacturer VAL riverdeep-learning-company COL price VAL 9.99	COL title VAL samsung business card holder COL manufacturer VAL  COL price VAL 9.99 ÔøΩÔøΩ	1
COL title VAL scrapbook for windows COL manufacturer VAL abacus COL price VAL 	COL title VAL scrapbook for windows COL manufacturer VAL abacus COL price VAL 6.99 galitarian	1
COL title VAL web graphics creator COL manufacturer VAL sos-aggregation-company COL price VAL 39.95	COL title VAL web graphics creator COL manufacturer VAL sr-d COL price VAL 40.99 ÔøΩÔøΩ	1
COL title VAL microsoft office student and teacher edition 2004 macintosh COL manufacturer VAL microsoft COL price VAL 149.99	COL title VAL microsoft office student and teacher edition 2004 macintosh COL manufacturer VAL microsoft COL price VAL 149.99 ONSORED	1
COL title VAL zoo tycoon 2 ( mac ) COL manufacturer VAL destineer COL price VAL 39.99	COL title VAL zoo tycoon 2 ( mac ) COL manufacturer VAL destineer COL price VAL 39	1
COL title VAL giggles computer funtime for baby shapes ( win/mac ) COL manufacturer VAL navarre ( software ) COL price VAL 24.95	COL title VAL giggles computer funtime for baby shapes ( win/mac ) COL manufacturer VAL navarre ( software ) COL price VAL 	1
COL title VAL sony vegas movie studio + dvd 8 platinum edition COL manufacturer VAL sony media COL price VAL 129.95	COL title VAL sony vegas movie studio + dvd 8 platinum edition COL manufacturer VAL  COL price VAL 129.95  ¬† ¬† ¬† ¬† ¬† _____________________________	1
COL title VAL circus ponies-notebook 2.0 mac os COL manufacturer VAL csdc COL price VAL 49.95	COL title VAL circus ponies-notebook 2.0 macOS OS COL manufacturer VAL csdc COL price VAL 39.99 galitarian	1
COL title VAL pc vegas dvd COL manufacturer VAL sony-pictures-home-entertainment COL price VAL 899.99	COL title VAL pc vegas dvd COL manufacturer VAL cvs COL price VAL 38.99 galitarian	1
COL title VAL microsoft virtual pc for mac 7.0 with windows xp home COL manufacturer VAL microsoft COL price VAL 219.99	COL title VAL microsoft virtual pc for mac 7.0 + windows xp home COL manufacturer VAL microsoft COL price VAL 393.68 nw	1
COL title VAL eovia carrara 5 pro COL manufacturer VAL eovia COL price VAL 	COL title VAL eovia carrara 5 pro COL manufacturer VAL  COL price VAL 29.99 íØ¥Âæç ÂØïÁæé ÂëüÈ†≠Áæé ÂñëÈ†≠Áæé Â∏Å‰π¢È†àÁæé ( )	1
COL title VAL comic book library COL manufacturer VAL marvel COL price VAL 49.99	COL title VAL comic book library 1.0 ( jc ) COL manufacturer VAL  COL price VAL 28.99 _______________________________	1
COL title VAL simple movie maker COL manufacturer VAL topics entertainment COL price VAL 19.99	COL title VAL pepsi computer COL manufacturer VAL  COL price VAL 15.99 vironment	1
COL title VAL mcsa/mcse self-paced training kit ( exams 70-292 & 70-296 ) upgrading your certi COL manufacturer VAL microsoft COL price VAL 70.0	COL title VAL mcsa/mcse self-paced training kit 'v 2.0 COL manufacturer VAL learning and support COL price VAL 78.96 galitarian	1
COL title VAL adobe after effects professional 7.0 COL manufacturer VAL adobe COL price VAL 999.0	COL title VAL adobe after effects professional 7.0 COL manufacturer VAL adobe COL price VAL 897.99 ÔøΩÔøΩ	1
COL title VAL sony vegas movie studio + dvd 8 platinum edition COL manufacturer VAL sony media COL price VAL 129.95	COL title VAL sony vegas movie studio 8 platinum edition COL manufacturer VAL sony content COL price VAL 129.95 „Äê	1
COL title VAL computrace lojack for laptops 1 year license ( mac ) COL manufacturer VAL absolute software COL price VAL 49.95	COL title VAL emirall zim toolbox calculator COL manufacturer VAL  COL price VAL 49.95 galitarian1	1
COL title VAL my sim aquarium COL manufacturer VAL viva media COL price VAL 19.99	COL title VAL my sim aquarium 2098 micro (x3) COL manufacturer VAL adsorption COL price VAL 69.95 ??????????????	1
COL title VAL winway resume deluxe 11.0 network 10 COL manufacturer VAL nova development COL price VAL 	COL title VAL winway resume deluxe 11.0 network 10 COL manufacturer VAL nova development COL price VAL tncx2	1
COL title VAL the sims 2 : open for business expansion pack COL manufacturer VAL aspyr media COL price VAL 34.99	COL title VAL the sims 2 : open for business expansion pack COL manufacturer VAL aspyr media COL price VAL 34.99	1
COL title VAL quickbooks pos : pro multistore 6.0 COL manufacturer VAL intuit inc. COL price VAL 1399.95	COL title VAL easyjumps 1.4 COL manufacturer VAL int COL price VAL 16.95 galitarian	1
COL title VAL adobe contribute cs3 [ mac ] COL manufacturer VAL adobe COL price VAL 149.0	COL title VAL adobe contribute cs3 [ mac ] COL manufacturer VAL adobe COL price VAL 149.0 galitarian	1
COL title VAL guild wars nightfall COL manufacturer VAL ncsoft COL price VAL 49.99	COL title VAL guild wars nightfall COL manufacturer VAL ncsoft COL price VAL 100.00 ONSORED	1
COL title VAL print workshop 2007 COL manufacturer VAL valusoft COL price VAL 19.99	COL title VAL print workshop 2007 COL manufacturer VAL print COL price VAL 003.98 galitarian	1
COL title VAL cosmi talking math & more for kids ( windows ) COL manufacturer VAL cosmi COL price VAL 	COL title VAL cosmi selling math for children ( win 58 me ) COL manufacturer VAL  COL price VAL 10.99 galitarian	1
COL title VAL soundtrack 1.2 COL manufacturer VAL apple COL price VAL 199.99	COL title VAL soundtrack 1.2 COL manufacturer VAL  COL price VAL 2599.0 galitarian	1
COL title VAL adventure workshop 4th-6th grade 7th edition COL manufacturer VAL encore software COL price VAL 19.99	COL title VAL adventure workshop 5th edition COL manufacturer VAL  COL price VAL 19.99 ÔøΩÔøΩÔøΩÔøΩ ÔøΩÔøΩÊ©üÊßã, INC. All rights reserved. Text and graphics are available with this file. All other copyright notices and copyright statements are included. Copyright 1998, 2001, 2004, 2007, 2008, 2011. All rights reserved.	1
COL title VAL adobe premiere pro 2.0 COL manufacturer VAL adobe COL price VAL 849.0	COL title VAL dota 3FREE 2.0 COL manufacturer VAL dota COL price VAL 49.95 galitarian	1
COL title VAL safekeeper plus COL manufacturer VAL bling software COL price VAL 	COL title VAL safekeeper plus COL manufacturer VAL bling COL price VAL ????????	1
COL title VAL tlc zoombinis 3rd grade lrng sys 2007 sb cs by riverdeep 10548 ) COL manufacturer VAL encore-software-inc COL price VAL 	COL title VAL aa scopop COL manufacturer VAL cc COL price VAL 17.49 orate	1
COL title VAL adobe creative suite cs3 design standard upgrade [ mac ] COL manufacturer VAL adobe COL price VAL 399.0	COL title VAL anti-spyware 3.0 win normal cs3 design standard upgrade cs3 COL manufacturer VAL adobe COL price VAL 490.99 ÔøΩÔøΩ	1
COL title VAL microsoft virtual pc for mac 7.0 with windows xp home COL manufacturer VAL microsoft COL price VAL 219.99	COL title VAL microsoft virtual pc for mac 7.0 with windows xp home COL manufacturer VAL microsoft COL price VAL 219.99 „ÄêMIN	1
COL title VAL punch super home suite 3.0 COL manufacturer VAL punch ! software COL price VAL 49.99	COL title VAL comadventure comadventure 4 comadventure computer graphics COL manufacturer VAL punch ! software COL price VAL 19.95 galitarian9	1
COL title VAL your desktop post office for pc COL manufacturer VAL stamps.com COL price VAL 14.99	COL title VAL your desktop post office for pc COL manufacturer VAL stamps.com COL price VAL 50.99 ":[](link=https	1
COL title VAL your desktop post office for pc COL manufacturer VAL stamps.com COL price VAL 14.99	COL title VAL stamps.com 47942 Postbox COL manufacturer VAL stamps.com COL price VAL 6	1
COL title VAL f/a -18 operation iraqi freedom COL manufacturer VAL graphics-simulations-corporation COL price VAL 39.99	COL title VAL f/a -18 operation iraqi freedom COL manufacturer VAL gc INC gc COL price VAL 18.99 ormon	1
COL title VAL clifford the big red dog thinking adventures COL manufacturer VAL scholastic COL price VAL 9.99	COL title VAL cliffordthe big red dog thinking adventures COL manufacturer VAL scholastic COL price VAL 9.999 „Ñ∑„Ñ∑„Ñ∑„Ñ∑„Ñ∑	1
COL title VAL soundtrack 1.2 COL manufacturer VAL apple COL price VAL 199.99	COL title VAL soundtrack 1.2 COL manufacturer VAL  COL price VAL 199.99 í≤§í∏≥‚Å°	1
COL title VAL learn to play chess with fritz & chesster 2 ( mac ) COL manufacturer VAL viva media COL price VAL 29.99	COL title VAL viva media read to play chess with fritz & chesster 2 ( mac ) COL manufacturer VAL  COL price VAL 99.99 orate	1
COL title VAL cisco security server agent for windows and solaris license 100 agents win solaris csa-b100-srvr-k9 ) COL manufacturer VAL cisco-systems-enterprise COL price VAL 	COL title VAL cisco security server agent for windows : security server for computers and solaris COL manufacturer VAL cisco-systems-enterprise ( computer systems ) COL price VAL *****************************	1
COL title VAL hoyle card games 2007 COL manufacturer VAL encore software COL price VAL 19.99	COL title VAL hoyle card games 2007 COL manufacturer VAL  COL price VAL 19.99 galitarian	1
COL title VAL gsp crossword addict COL manufacturer VAL global-software-publishing-north-america-inc COL price VAL 9.99	COL title VAL gsp crossword addict COL manufacturer VAL gte COL price VAL 9.99 galitarian1	1
COL title VAL x3 : reunion virtual programming ltd. COL manufacturer VAL csdc COL price VAL 39.95	COL title VAL csdc x3 : reunion virtual programming ltd. COL manufacturer VAL csdc COL price VAL 41.46 galitarian1	1
COL title VAL scooby doo glowing bug man ( jewel case ) COL manufacturer VAL encore software COL price VAL 9.99	COL title VAL zebler dvd movies cv3 COL manufacturer VAL  COL price VAL 9.99 galitarian1	1
COL title VAL emc retrospect 7.5 professional for windows upgrade COL manufacturer VAL dantz COL price VAL 	COL title VAL emc audition 2013, 2013 x86 x64 COL manufacturer VAL  COL price VAL 14.97 ItemThumbnailImage	1
COL title VAL britannica deluxe COL manufacturer VAL avanquest software COL price VAL 29.95	COL title VAL britannica deluxe COL manufacturer VAL avanquest software PLUS COL price VAL 479.95	1
COL title VAL wild photo effects ( jewel case ) COL manufacturer VAL on-hand-software COL price VAL 9.99	COL title VAL wild photo effects ( jewel case ) COL manufacturer VAL  COL price VAL 9.69 galitarian1	1
COL title VAL microsoft word 2004 upgrade ( mac ) COL manufacturer VAL microsoft COL price VAL 109.99	COL title VAL microsoft word 2 COR 2009 upgrade COL manufacturer VAL product COL price VAL 79.99 galitarian1	1
COL title VAL punch ! home design architectural series 4000 v10 COL manufacturer VAL punch ! software COL price VAL 199.99	COL title VAL punch ! 3D printer software m7 COL manufacturer VAL punch ! 3D printer software n9 COL price VAL 14.9	1
COL title VAL sony vegas movie studio + dvd 8 platinum edition COL manufacturer VAL sony media COL price VAL 129.95	COL title VAL sony vegas movie studio + dvd v8 platinum edition COL manufacturer VAL  COL price VAL 129.95 ÔøΩÔøΩ	1
COL title VAL math success deluxe 2006 COL manufacturer VAL topics entertainment COL price VAL 49.99	COL title VAL math success deluxe 2006 COL manufacturer VAL  COL price VAL 49.99 ÔøΩÔøΩ	1
COL title VAL punch ! master landscape & home design COL manufacturer VAL punch ! software COL price VAL 99.99	COL title VAL punch textured layout COL manufacturer VAL punch textured layout col COL price VAL 99.99 „Äê$0.00 shipping in the USA„ÄëCol title	1
COL title VAL steinberg nuendo 3 digital audio software COL manufacturer VAL steinberg COL price VAL 2499.0	COL title VAL steinberg nuendo 3 digital audio software COL manufacturer VAL  COL price VAL 23.99 galitarian	1
COL title VAL pc professor fuji 's kakuro COL manufacturer VAL encore software COL price VAL 9.99	COL title VAL pc professor fuji 's kakuro COL manufacturer VAL encore software COL price VAL 89.99 galitarian1	1
COL title VAL print workshop 2007 COL manufacturer VAL valusoft COL price VAL 19.99	COL title VAL print workshop 2007 COL manufacturer VAL  COL price VAL 19.95 ÔøΩÔøΩ	1
COL title VAL guild wars nightfall COL manufacturer VAL ncsoft COL price VAL 49.99	COL title VAL guild battles nightfall COL manufacturer VAL  COL price VAL 499.99 ÔøΩÔøΩ1	1
COL title VAL scrapbook for windows COL manufacturer VAL abacus COL price VAL 	COL title VAL scrapbook for windows COL manufacturer VAL  COL price VAL 169.99 ilstraccoltitle	1
COL title VAL print explosion deluxe 3.0 ( mac ) COL manufacturer VAL nova development COL price VAL 49.99	COL title VAL pylons for webOS ARM environment COL manufacturer VAL  COL price VAL 89.96 galitarian1	1
COL title VAL adobe premiere pro 2.0 COL manufacturer VAL adobe COL price VAL 849.0	COL title VAL adobe premiere pro 3.0 COL manufacturer VAL adobe COL price VAL 87946.99 galitarian	1
COL title VAL firstedge v 2.0 ( mac ) COL manufacturer VAL myob us COL price VAL 99.95	COL title VAL dk. dk dot11 dk for 4th grader cols COL manufacturer VAL myob us COL price VAL 99.95 „Äê	1
COL title VAL adobe premiere pro cs3 COL manufacturer VAL adobe COL price VAL 799.0	COL title VAL adobe Premiere 2015 8. COL manufacturer VAL  COL price VAL 23.17 galitarian	1
COL title VAL adobe after effects cs3 COL manufacturer VAL adobe COL price VAL 999.0	COL title VAL adobe after effects 4 e COL manufacturer VAL adobe COL price VAL 789.99 galitarian1	1
COL title VAL model web publisher 3.5.2 . COL manufacturer VAL computer-associates-international COL price VAL 	COL title VAL model web publisher 3.5.2 . COL manufacturer VAL web publishers with online catalog COL price VAL 8.99 galitarian	1
COL title VAL poser figure artist COL manufacturer VAL efrontier COL price VAL 99.99	COL title VAL poser figure artist COL manufacturer VAL  COL price VAL 9.59 ÔøΩÔøΩ	1
COL title VAL sibelius 4 educational edition COL manufacturer VAL sibelius-software-ltd . COL price VAL 329.0	COL title VAL sibelius 4 educational edition COL manufacturer VAL  COL price VAL 329.0 galitarian	1
COL title VAL model web publisher 3.5.2 . COL manufacturer VAL computer-associates-international COL price VAL 	COL title VAL model web publisher 3.5.2 . COL manufacturer VAL computer-associates-international COL price VAL 	1
COL title VAL imsi resume writer deluxe [ lb ] COL manufacturer VAL imsi design COL price VAL 19.95	COL title VAL imsi resume writer del COL manufacturer VAL aspyr COL price VAL 17.95 galitarian	1
COL title VAL hallmark blank greeting cards half-fold matte premium 20 count COL manufacturer VAL nova development COL price VAL 12.99	COL title VAL hallmark blank greeting cards half- COL manufacturer VAL  COL price VAL 17.55 galitarian	1
COL title VAL sound forge audio studio 9 COL manufacturer VAL sony media COL price VAL 69.59	COL title VAL sound forge audio studio 9 COL manufacturer VAL  COL price VAL 69.59 „ÉªGENERAL INFORMATION AND TERMS OF USE ‚Äì GENERAL	1
COL title VAL microsoft visual studio team edition for software testers 2005 w/msdn premium renewal COL manufacturer VAL microsoft software COL price VAL 2309.0	COL title VAL microsoft visual studio project edition 2005 COL manufacturer VAL msdn premium renew COL price VAL 18.9 „ÖìÏù¥	1
COL title VAL 1pk internet sec ste 2007 oem COL manufacturer VAL ca oem COL price VAL 	COL title VAL 1pk internet sec ste 2007 OEM COL manufacturer VAL au oem COL price VAL „Äê]„Äê]„Äê]„Äê]„Äê]„Äê]„Äê]„Äê]„Äê]„Äê]„Äê]„Äê]„Äê]	1
COL title VAL punch ! master landscape & home design COL manufacturer VAL punch ! software COL price VAL 59.99	COL title VAL punch ! master landscape & home design COL manufacturer VAL punch ! software COL price VAL 47.99 galitarianCol title	1
COL title VAL print explosion deluxe 3.0 ( mac ) COL manufacturer VAL nova development COL price VAL 49.99	COL title VAL print explosion DELUXE CORPORATION . DECEASED COL manufacturer VAL nova_dev COL price VAL 39.93 orate	1
COL title VAL captain america the complete comic collection win/mac COL manufacturer VAL git corp COL price VAL 49.95	COL title VAL captain america the complete comic collection win/mac COL manufacturer VAL ls col COL price VAL 9.9 vironment	1
COL title VAL tlc dr. seuss reading learning system 2008 COL manufacturer VAL encore COL price VAL 19.99	COL title VAL tlc dr. seuss reading learning system 2nd edition cnn COL manufacturer VAL lgct COL price VAL 9.99 galitarianCol title	1
COL title VAL quickbooks customer manager 2.5 COL manufacturer VAL intuit COL price VAL 79.95	COL title VAL quickBooks user 3.2 e COL manufacturer VAL  COL price VAL 79.95 IRED	1
COL title VAL travelogue 360 : paris COL manufacturer VAL aspyr media COL price VAL 29.99	COL title VAL yoyo kyo yoyo 2014 COL manufacturer VAL aspyr MEDIA FORMAT COL price VAL 17.99 *******************	1
COL title VAL broderbund print shop 21 deluxe COL manufacturer VAL encore software COL price VAL 49.99	COL title VAL broderbund print shop inc 2d COL manufacturer VAL 3-in-one 3d print shop inc 3d COL price VAL 49.99 galitarian	1
COL title VAL microsoft visual studio team suite 2005 with msdn premium ( cd & dvd ) COL manufacturer VAL microsoft COL price VAL 10949.0	COL title VAL microsoft visual studio team suite 2005 with msdn premium ( cd & dvd ) COL manufacturer VAL  COL price VAL 10949.0 galitarian	1
COL title VAL weekly reader mastering elementary/middle school math learning COL manufacturer VAL fogware publishing COL price VAL 19.99	COL title VAL monthly reader managing elementary and middle school computers & media COL manufacturer VAL  COL price VAL 744.45 ONSORED	1
COL title VAL gsp greatest moments of our time COL manufacturer VAL global-software-publishing-north-america-inc COL price VAL 9.99	COL title VAL gsp greatest moments of our time COL manufacturer VAL gsp COL price VAL 9.99 galitarian	1
COL title VAL time money & fractions grades 1-2 COL manufacturer VAL school zone COL price VAL 9.99	COL title VAL school zone COL manufacturer VAL  COL price VAL 79.44 „Ñá„ÑÖ„ÑÖ ÌòºÏ†ú ÌòøÌïòÎÖïÎÑêÎ∏à	1
COL title VAL window washer COL manufacturer VAL navarre ( software ) COL price VAL 29.95	COL title VAL window washer indellux COL manufacturer VAL  COL price VAL 29.97 ÔøΩËøë‰∏≠Â∑Æ	1
COL title VAL apple remote desktop 2.2 10 client ( old version ) COL manufacturer VAL apple COL price VAL 299.0	COL title VAL apple remote desktop 2.2 for Mac COL manufacturer VAL apple for MAC COL price VAL 399.0 galitarian	1
COL title VAL computrace lojack for laptops 1 year license ( mac ) COL manufacturer VAL absolute software COL price VAL 49.95	COL title VAL computrace lojack for laptops 1 year license ( mac ) COL manufacturer VAL absolute software COL price VAL 49.95 „ÄêDEP	1
COL title VAL the printshop 20 professional publisher COL manufacturer VAL broderbund COL price VAL 69.99	COL title VAL the printshop 20 professional publisher COL manufacturer VAL broderbund COL price VAL 69.99 ÔøΩ	1
COL title VAL onone software pxl smartscale windows and macintosh ) COL manufacturer VAL onone software COL price VAL 	COL title VAL onone software pxl smartscale windows and macintosh COL manufacturer VAL  COL price VAL 18.98 „ÄêCUSTOM name is different than CALNAME„Äë	1
COL title VAL adventure workshop 4th-6th grade 7th edition COL manufacturer VAL encore software COL price VAL 19.99	COL title VAL encore software 15100 2d adventure workshop 3rd edition COL manufacturer VAL  COL price VAL 23.98 galitarian	1
COL title VAL scrapbook for windows COL manufacturer VAL abacus COL price VAL 	COL title VAL quicken 2011 computer version 1 for mac COL manufacturer VAL arxiv COL price VAL 33.95 ßé£ÔøΩ	1
COL title VAL the sims 2 : open for business expansion pack COL manufacturer VAL aspyr media COL price VAL 34.99	COL title VAL the sims 2 : open for business expansion pack COL manufacturer VAL aspyr publishing COL price VAL 33.99 ONSORED	1
COL title VAL adobe creative suite cs3 design standard upsell [ mac ] COL manufacturer VAL adobe COL price VAL 899.0	COL title VAL adobe_media_scholar_edition COL manufacturer VAL adobe COL price VAL 21.99 _______________________________	1
COL title VAL sibelius 4 educational edition COL manufacturer VAL sibelius-software-ltd . COL price VAL 329.0	COL title VAL sibelius 4 educational edition COL manufacturer VAL mpc-com. CO COL price VAL 33.01 Regarding educational edition by sibelius	1
COL title VAL global software smart steps 1st grade windows macintosh ) COL manufacturer VAL global software COL price VAL 	COL title VAL digital COL manufacturer VAL digital COL price VAL orate	1
COL title VAL mcsa/mcse self-paced training kit ( exams 70-292 & 70-296 ) upgrading your certi COL manufacturer VAL microsoft COL price VAL 70.0	COL title VAL microsoft i83.5 self-paced training kit COL manufacturer VAL  COL price VAL 69.99 galitarian	1
COL title VAL punch ! professional home design COL manufacturer VAL punch ! software COL price VAL 89.99	COL title VAL punch ! professional home design COL manufacturer VAL punch! online COL price VAL 49.29 galitarian	1
COL title VAL i love the usa COL manufacturer VAL global-software-publishing COL price VAL 9.99	COL title VAL i love the usa COL manufacturer VAL global-software-publishing COL price VAL 	1
COL title VAL cyberchase adventures : carnival chaos and casablanca quest COL manufacturer VAL brighter-minds-media-inc . COL price VAL 19.99	COL title VAL cyberchase adventures : carnival chaos and casablanca quest COL manufacturer VAL Cyberchase ADVANCED CO., INC . COL price VAL 189.99 nw	1
COL title VAL i love the usa COL manufacturer VAL global-software-publishing COL price VAL 9.99	COL title VAL usa $1 COORDINATED COL manufacturer VAL ÔøΩÔøΩ COL price VAL 9.99 ÔøΩÔøΩ	1
COL title VAL quicken 2007 premier COL manufacturer VAL intuit COL price VAL 79.95	COL title VAL iaud COL manufacturer VAL  COL price VAL 89.00 ÔøΩÔøΩ	1
COL title VAL neuratron photoscore professional 4 COL manufacturer VAL sibelius-software-ltd . COL price VAL 199.99	COL title VAL neuratron photoscore professional 4 COL manufacturer VAL  COL price VAL 199.99 galitarian	1
COL title VAL corel wordperfect office 12 standard upgrade COL manufacturer VAL corel COL price VAL 149.99	COL title VAL corel wordperfect office 151002-003-2 ln COL manufacturer VAL wordperfect COL price VAL 	1
COL title VAL adobe contribute cs3 [ mac ] COL manufacturer VAL adobe COL price VAL 149.0	COL title VAL adobe contributing cs3 video editing software for Windows Professional Studio COL manufacturer VAL  COL price VAL 149.0 Àà…õ	1
COL title VAL cute ftp COL manufacturer VAL tri synergy COL price VAL 39.99	COL title VAL ecol carton COL manufacturer VAL carton COL price VAL 9.99 ____________	1
COL title VAL adobe after effects cs3 COL manufacturer VAL adobe COL price VAL 999.0	COL title VAL adobe after effects cs3 music COL manufacturer VAL  COL price VAL 999.0 ONSORED	1
COL title VAL media studio for psp standard editon COL manufacturer VAL encore software COL price VAL 29.99	COL title VAL media studio for psp standard editon COL manufacturer VAL  COL price VAL 29.99 galitarian	1
COL title VAL adobe photoshop cs3 extended [ mac ] COL manufacturer VAL adobe COL price VAL 999.0	COL title VAL adobe photoshop cs3 COL manufacturer VAL  COL price VAL 14.99 Irecol title	1
COL title VAL global software smart steps 1st grade windows macintosh ) COL manufacturer VAL global software COL price VAL 	COL title VAL global software smart steps 1st grade windows macintosh COL manufacturer VAL  COL price VAL 	1
COL title VAL the human body COL manufacturer VAL topics entertainment COL price VAL 19.99	COL title VAL human body section COL manufacturer VAL  COL price VAL 189.99 galitarian	1
COL title VAL power on now up to date & contact windows COL manufacturer VAL power-on-software COL price VAL 129.99	COL title VAL print wallpaper COL manufacturer VAL power-on-software COL price VAL 	1
COL title VAL extensis smartscale 1-user pxe-11433 ) COL manufacturer VAL extensis corporation COL price VAL 	COL title VAL extensis smartscale software x11c ( a9623hq ) COL manufacturer VAL extensis smartscale COL price VAL 149.99 ____________________________	1
COL title VAL microsoft word 2004 upgrade ( mac ) COL manufacturer VAL microsoft COL price VAL 109.99	COL title VAL game COL manufacturer VAL  COL price VAL 27.29 galitarianicol1	1
COL title VAL adobe premiere elements 3.0 [ lb ] COL manufacturer VAL adobe COL price VAL 99.99	COL title VAL adobe PERIODING 3.0 premium materials COL manufacturer VAL adobe COL price VAL __________	1
COL title VAL finale allegro 2007 COL manufacturer VAL finale COL price VAL 199.95	COL title VAL FINAL FANTASY ( eBook reader ) COL manufacturer VAL content COL price VAL 29.99 galitarian	1
COL title VAL adobe photoshop cs3 extended [ mac ] COL manufacturer VAL adobe COL price VAL 999.0	COL title VAL inbound comlink COL manufacturer VAL  COL price VAL 15.49 ÔøΩÔøΩ	1
COL title VAL the print shop pro publisher 22 deluxe [ dvd ] COL manufacturer VAL encore COL price VAL 99.99	COL title VAL the print shop pro publisher 24 deluxe [ wv ] COL manufacturer VAL encore COL price VAL 99.99 ONSORED	1
COL title VAL adobe premiere pro cs3 COL manufacturer VAL adobe COL price VAL 799.0	COL title VAL adobe premiere pro cs3 COL manufacturer VAL adobe COL price VAL 799.99 galitarian1	1
COL title VAL tlc dr. seuss reading learning system 2008 COL manufacturer VAL encore COL price VAL 19.99	COL title VAL tlc dr. seuss reading learning system 2012 COL manufacturer VAL encore COL price VAL 15.99 †®éÔøΩ†à¥†îêÔøΩ ( aap-misc-parts )	1
COL title VAL scooby doo glowing bug man ( jewel case ) COL manufacturer VAL encore software COL price VAL 9.99	COL title VAL scooby doo glowing bug man ( jewel case ) inc. pc OS COL manufacturer VAL encore COL price VAL 9.00 ____________________________NETWORK	1
COL title VAL adobe cs3 design premium macosx dvd COL manufacturer VAL adobe COL price VAL 599.0	COL title VAL adobe cs3 design premium macosx dvd COL manufacturer VAL adobe COL price VAL 599.0 ÀàÃ±Œß…ôÃ∞…îƒç…ùÔøΩ	1
COL title VAL gsp greatest moments of our time COL manufacturer VAL global-software-publishing-north-america-inc COL price VAL 9.99	COL title VAL gsp greatest moments of our time COL manufacturer VAL world-solutions-multimedia-col COL price VAL 43.99 galitarian	1
COL title VAL guild wars nightfall COL manufacturer VAL ncsoft COL price VAL 49.99	COL title VAL ncsoft store COL manufacturer VAL  COL price VAL 49.99 ________________________	1
COL title VAL broderbund print shop 21 deluxe COL manufacturer VAL encore software COL price VAL 49.99	COL title VAL broderbund print shop 21 deluxe . COL manufacturer VAL abncol COL price VAL 29.99 qqa	1
COL title VAL middle school success deluxe 2008 COL manufacturer VAL topics entertainment COL price VAL 49.99	COL title VAL middle school success deluxe mac COL manufacturer VAL  COL price VAL 49.99 galitarian	1
COL title VAL hallmark blank greeting cards half-fold matte premium 20 count COL manufacturer VAL nova development COL price VAL 12.99	COL title VAL mark mark mark for COL manufacturer VAL  COL price VAL 49.98 galitarian	1
COL title VAL elementary school advantage 2007 COL manufacturer VAL encore software COL price VAL 29.99	COL title VAL elementary school advantage CC COL manufacturer VAL insti COL price VAL 49.99 galitarian	1
COL title VAL age of empires iii COL manufacturer VAL destineer COL price VAL 49.99	COL title VAL age of empires v 3.0 COL manufacturer VAL ingame COL price VAL 49.01 galitarian	1
COL title VAL hoyle solitaire ( jewel case ) COL manufacturer VAL encore COL price VAL 9.99	COL title VAL hoyle solitaire 5th-6th grade 7th ed sb cs cs by seadeep COL manufacturer VAL  COL price VAL 18.99 galitarian1	1
COL title VAL hallmark blank greeting cards half-fold matte premium 20 count COL manufacturer VAL nova development COL price VAL 12.99	COL title VAL am COL manufacturer VAL nova software COL price VAL 13.99 íååíåΩíåΩ‚Äé	1
COL title VAL math success deluxe 2007 COL manufacturer VAL topics entertainment COL price VAL 39.99	COL title VAL math success deluxe 2007 COL manufacturer VAL x-math COL price VAL 99.95 „ÄêC	1
COL title VAL emc retrospect 7.5 professional for windows upgrade COL manufacturer VAL dantz COL price VAL 	COL title VAL emc retrospect 7.5 professional for windows upgrade COL manufacturer VAL dantz COL price VAL ‡ºº‡∫àŸÑÕú‡∫à‡ºΩ‡∫à‡ºÜ ‡ºΩ„Å§ STREAM ‡ºº‡∫à	1
COL title VAL punch ! home design architectural series 18 COL manufacturer VAL punch ! software COL price VAL 129.99	COL title VAL punch ! home design architecture series 18 COL manufacturer VAL punch ! software COL price VAL 129.99 ®≥ä	1
COL title VAL singleclick network now ! pro COL manufacturer VAL encore software COL price VAL 39.99	COL title VAL singleclick NETWORK NOW! PRO COL manufacturer VAL inc COL price VAL 14.85 galitarian	1
COL title VAL webexpress COL manufacturer VAL ingram micro COL price VAL 69.99	COL title VAL webexpress webexpress version 8 millimeters, 12 kilos COL manufacturer VAL ingram micro COL price VAL 69.	1
COL title VAL marine aquarium 2.0 ( mac ) COL manufacturer VAL encore COL price VAL 19.99	COL title VAL marine aquarium 2.0 ( mac ) COL manufacturer VAL programs and instructional software COL price VAL 19.99 galitarian	1
COL title VAL model web publisher 3.5.2 . COL manufacturer VAL computer-associates-international COL price VAL 	COL title VAL model web publisher 3.5.2 ( pc ) COL manufacturer VAL  COL price VAL ‡ºë‡º±‡ºë‡ºë‡ºë‡ºë‡ºë‡ºë‡ºë‡ºë‡ºë‡ºë‡ºë‡ºë‡ºë‡ºë‡ºë‡ºë‡ºë‡ºë‡ºë‡ºëÔøΩ	1
COL title VAL sibelius 4 educational edition COL manufacturer VAL sibelius-software-ltd . COL price VAL 329.0	COL title VAL sibelius 4 educational edition COL manufacturer VAL  COL price VAL 329.0 ÔøΩÔøΩ	1
COL title VAL personal image manager COL manufacturer VAL smith-micro-software COL price VAL 29.99	COL title VAL personal image manager ( win, mac ) COL manufacturer VAL  COL price VAL 29.99 galitarian	1
COL title VAL adobe contribute cs3 [ mac ] COL manufacturer VAL adobe COL price VAL 149.0	COL title VAL dvo cook 'n deluxe 9.0 ultimate project CORSA COL manufacturer VAL  COL price VAL 935.99 ___________________________	1
COL title VAL i love the usa COL manufacturer VAL global-software-publishing COL price VAL 9.99	COL title VAL i love the usa col manufacturer COL manufacturer VAL universal-online COL price VAL ÔøΩÔøΩ	1
COL title VAL sudoku puzzle addict : unlimited edition COL manufacturer VAL global-software-publ-na COL price VAL 	COL title VAL sudoku puzzle addict : unlimited edition COL manufacturer VAL ezc CR-E11 cols COL price VAL 89.99 ONSORED	1
COL title VAL winway resume deluxe 11.0 network 10 COL manufacturer VAL nova development COL price VAL 	COL title VAL nova development COL manufacturer VAL  COL price VAL 36.99 ÔøΩÔøΩ	1
COL title VAL winway resume deluxe 11.0 network 10 COL manufacturer VAL nova development COL price VAL 	COL title VAL programrunner, rewind 7.0 web program COL manufacturer VAL  COL price VAL 87.99 ßà∂ùáπùáπ	1
COL title VAL x-oom internet movies 2 COL manufacturer VAL x-oom COL price VAL 	COL title VAL x-oom Internet movies 2 college movie COL manufacturer VAL  COL price VAL 88.55 ___________	1
COL title VAL adobe pagemaker v7 .0.2 cd mac-upg 17530402 ) COL manufacturer VAL adobe COL price VAL 138.45	COL title VAL pagemaker v7 cd MAC-UPg COL manufacturer VAL  COL price VAL 137.35 ________________________ÔøΩÔøΩ ________________________ÔøΩÔøΩ cols BASIC INDEX 1A3	1
COL title VAL form workshop 1200 COL manufacturer VAL valusoft COL price VAL 29.99	COL title VAL form workshop 1200 COL manufacturer VAL freebase COL price VAL 38.99 _____________________________ ___ _ _ ___ _ ___ _ _ ___ ___ _ ___ ___ _	1
COL title VAL punch super home suite 3.0 COL manufacturer VAL punch ! software COL price VAL 49.99	COL title VAL punch super home suite 47840 home suite col COL manufacturer VAL punch ! software COL price VAL 29.99 ÔøΩÔøΩ	1
COL title VAL pc professor fuji 's kakuro COL manufacturer VAL encore software COL price VAL 9.99	COL title VAL pc professor fuji 's kakuro COL manufacturer VAL encore COL price VAL 8.99 Likewise, this unit does not work in MacOS X or OS X 10.0 (or	1
COL title VAL world book encyclopedia 2006 COL manufacturer VAL topics entertainment COL price VAL 19.99	COL title VAL world book encyclopedia 2006 COL manufacturer VAL books COL price VAL 19.95 galitarian	1
COL title VAL power on now up to date & contact windows COL manufacturer VAL power-on-software COL price VAL 129.99	COL title VAL power-on-software COL manufacturer VAL aspyr COL price VAL 99.99 galitarian	1
COL title VAL symantec pcanywhere 12.0 host only COL manufacturer VAL symantec COL price VAL 169.65	COL title VAL 2ch games on 4. COL manufacturer VAL symantec COL price VAL 169.65 galitarian1	1
COL title VAL e-mu em8669 modern symphonic orchestra COL manufacturer VAL e-mu COL price VAL 499.99	COL title VAL e-mu em8669 classic symphonic orchestra COL manufacturer VAL e-mu COL price VAL 399.99 galitarianCol title	1
COL title VAL adobe premiere pro 2.0 COL manufacturer VAL adobe COL price VAL 849.0	COL title VAL adobe Premiere pro ( jc ) COL manufacturer VAL adobe COL price VAL 14.99 ÔøΩÔøΩ	1
COL title VAL comic book library COL manufacturer VAL marvel COL price VAL 49.99	COL title VAL comic book library COL manufacturer VAL comics COL price VAL 46.99 ÔøΩÔøΩ	1
COL title VAL microsoft powerpoint 2004 upgrade ( mac ) COL manufacturer VAL microsoft COL price VAL 109.99	COL title VAL coinsh COL manufacturer VAL  COL price VAL 89.99 galitarian	1
COL title VAL handmark oxford american desk dictionary and thesaurus COL manufacturer VAL handmark inc. . COL price VAL 	COL title VAL handmark inc. 6 COL manufacturer VAL adb-desktop-computer-i COL price VAL _______________________________	1
COL title VAL quickbooks pos : pro multistore 6.0 COL manufacturer VAL intuit inc. COL price VAL 1399.95	COL title VAL quickbooks pos : pro multistore 6.0 COL manufacturer VAL long runners COL price VAL 599.0 ‚Äì‚Äì‚Äì‚Äì‚Äì‚Äì‚Äì‚Äì‚Äì‚Äì‚Äì‚Äì‚Äì‚Äì‚Äì‚Äì‚Äì‚Äì‚Äì‚Äì‚Äì‚Äì‚Äì‚Äì‚Äì‚Äì	1
COL title VAL gsp greatest moments of our time COL manufacturer VAL global-software-publishing-north-america-inc COL price VAL 9.99	COL title VAL gsp greatest moments of our time COL manufacturer VAL  COL price VAL 8.99 galitarian1	1
COL title VAL adobe creative suite cs3 design standard upsell [ mac ] COL manufacturer VAL adobe COL price VAL 899.0	COL title VAL adobe creative suite cs3 COL manufacturer VAL  COL price VAL 895.99 ocally	1
COL title VAL eovia carrara 4 pro win/mac COL manufacturer VAL eovia corporation COL price VAL 599.99	COL title VAL Eovia CARRARA 3 win/mac COL manufacturer VAL eovia corporation COL price VAL 48.95 ÔøΩÔøΩÔøΩÔøΩÏÜåÏÑ∏Ìè¨ÏùÑ ÎåÄÌè¨Ìè¨Îìâ Ìï¥ÏÑ∏Ìä∏	1
COL title VAL logic pro 6 COL manufacturer VAL apple COL price VAL 999.99	COL title VAL logic pro COL manufacturer VAL aspyr COL price VAL 94.99 galitarian	1
COL title VAL your desktop post office for pc COL manufacturer VAL stamps.com COL price VAL 14.99	COL title VAL your desktop post office for pc COL manufacturer VAL stamps.com COL price VAL 31.99 ¶ÇÖ	1
COL title VAL adobe cs3 design premium macosx dvd COL manufacturer VAL adobe COL price VAL 599.0	COL title VAL design premium dvd COL manufacturer VAL adobe COL price VAL 599.0 ÔøΩÔøΩ	1
COL title VAL firstedge v 2.0 ( mac ) COL manufacturer VAL myob us COL price VAL 99.95	COL title VAL firstedge v 2.0 ( mac ) COL manufacturer VAL myob us COL price VAL 89.95 ÔøΩÔøΩ	1
COL title VAL x-oom internet movies 2 COL manufacturer VAL x-oom COL price VAL 	COL title VAL dvorak audio software 6 COL manufacturer VAL  COL price VAL _______________________________	1
COL title VAL emc retrospect 7.5 professional for windows upgrade COL manufacturer VAL dantz COL price VAL 	COL title VAL emc retrospect 7.2 professional for windows upgrade COL manufacturer VAL  COL price VAL 19.99 jri	1
COL title VAL hoyle card games ( jewel case ) COL manufacturer VAL encore software COL price VAL 9.99	COL title VAL hoyle card games ( jewel case ) ( jewel case ) ( jewel case ) COL manufacturer VAL  COL price VAL 9	1
COL title VAL apple ilife '06 ( mac dvd ) [ older version ] COL manufacturer VAL apple computer COL price VAL 79.0	COL title VAL iridata iridata apple for i386 COL manufacturer VAL  COL price VAL 79.99 galitarianCol title	1
COL title VAL peachtree by sage premium accounting 2007 COL manufacturer VAL sage software COL price VAL 499.99	COL title VAL peachtree by sage premium accounting COL manufacturer VAL  COL price VAL 442.48 vironment	1
COL title VAL giggles computer funtime for baby shapes ( win/mac ) COL manufacturer VAL navarre ( software ) COL price VAL 24.95	COL title VAL giggles computer funtime for baby shapes COL manufacturer VAL navarre ( software ) COL price VAL 24.95 galitarian	1
COL title VAL adobe creative suite cs3 master collection upgrade [ mac ] COL manufacturer VAL adobe COL price VAL 1399.0	COL title VAL adobe creatura COL manufacturer VAL adobe COL price VAL 5.98 ÔøΩÔøΩ	1
COL title VAL tune tools for ipod ( win/mac ) COL manufacturer VAL valusoft COL price VAL 19.99	COL title VAL netmusic company INC . COL manufacturer VAL  COL price VAL 23.39 ÔøΩÔøΩ	1
COL title VAL time money & fractions grades 1-2 COL manufacturer VAL school zone COL price VAL 9.99	COL title VAL time money & fractions grades 2 COL manufacturer VAL sos COL price VAL 99.99 ÔøΩÔøΩ	1
COL title VAL gsp greatest moments of our time COL manufacturer VAL global-software-publishing-north-america-inc COL price VAL 9.99	COL title VAL gsp greatest moments of our time COL manufacturer VAL  COL price VAL 148.3 êäõêäõ	1
COL title VAL peachtree by sage pro accounting 2007 COL manufacturer VAL sage software COL price VAL 169.99	COL title VAL peachtree by sage pro accounting 2007 COL manufacturer VAL sage . COL price VAL 129.48 ÔøΩÔøΩÔøΩÔøΩ‰∏ã ÔøΩÔøΩÔøΩÔøΩ‰∏ã	1
COL title VAL instant immersion japanese 2.0 COL manufacturer VAL topics entertainment COL price VAL 19.99	COL title VAL  COL manufacturer VAL topics entertainment COL price VAL 79.99 vironment2	1
COL title VAL cyberchase adventures : carnival chaos and casablanca quest COL manufacturer VAL brighter-minds-media-inc . COL price VAL 19.99	COL title VAL cyberchase adventures : carnival COL manufacturer VAL  COL price VAL 19.99 ÔøΩÔøΩ	1
COL title VAL individual small business advantage deluxe 2006 COL manufacturer VAL individual COL price VAL 49.99	COL title VAL individual small business advantage deluxe 616 COL manufacturer VAL individual COL price VAL 49.99 ONSORED	1
COL title VAL quicken 2007 premier COL manufacturer VAL intuit COL price VAL 79.95	COL title VAL easy to understand COL manufacturer VAL intuit COL price VAL 80.99 galitarian	1
COL title VAL procurve mobility manager 1.0 is a plug-in module for procurve manager plus 2.0 COL manufacturer VAL hewlett packard COL price VAL 	COL title VAL procurve mobility manager com2 xe-cart service store COL manufacturer VAL indivisualCOR price COL price VAL __________________________	1
COL title VAL wild photo effects ( jewel case ) COL manufacturer VAL on-hand-software COL price VAL 9.99	COL title VAL wild photo effects COL manufacturer VAL gray COR maker COL price VAL ibr	1
COL title VAL monopoly here & now COL manufacturer VAL encore COL price VAL 19.95	COL title VAL monopoly here & now COL manufacturer VAL  COL price VAL 19.97 ÔøΩÔøΩ	1
COL title VAL best of slots 2 ( jewel case ) COL manufacturer VAL masque publishing COL price VAL 9.99	COL title VAL best of slots 2 ( jewel case ) COL manufacturer VAL masque publishing COL price VAL 10.99 ________________________ _ ( 2.9184533456715444588	1
COL title VAL instant immersion spanish ( audio book ) COL manufacturer VAL topics entertainment COL price VAL 	COL title VAL instant immersion spanish ( audio book ) COL manufacturer VAL topics entertainment COL price VAL ONSORED	1
COL title VAL onone software intellihance pro 4.1 COL manufacturer VAL onone software COL price VAL 	COL title VAL onone software intellihance pro 4.2 COL manufacturer VAL onone software COL price VAL 1299.97 galitarian1	1
COL title VAL make music finale 2008 academic COL manufacturer VAL emedia COL price VAL 350.0	COL title VAL make music finale 2008 alc COL manufacturer VAL emedia COL price VAL 365.08 galitarian	1
COL title VAL chicken hunter : license to grill the great poultry race COL manufacturer VAL encore COL price VAL 9.99	COL title VAL chicken hunter : license to grill the great poultry race COL manufacturer VAL  COL price VAL 9.99 ÔøΩÔøΩ	1
COL title VAL clifford the big red dog thinking adventures COL manufacturer VAL scholastic COL price VAL 9.99	COL title VAL scholastic software 3.0 COL manufacturer VAL  COL price VAL 3.99 ÔøΩÔøΩ	1
COL title VAL apple garageband jam pack : remix tools COL manufacturer VAL apple COL price VAL 99.0	COL title VAL apple garageband jam pack : remix tools COL manufacturer VAL apple COL price VAL 9.02 _.CENTRIA	1
COL title VAL iremember digital scrapbooking 2.0 COL manufacturer VAL intriguing development COL price VAL 39.95	COL title VAL iremember virtual scrapbooks COL manufacturer VAL intriguing development COL price VAL orate	1
COL title VAL punch super home suite 3.0 COL manufacturer VAL punch ! software COL price VAL 49.99	COL title VAL punch super home suite 3.0 COL manufacturer VAL markup COL price VAL 47.97 ________________	1
COL title VAL internet cleanup 4.0 mac os 10.4 or higher COL manufacturer VAL smith-micro-software COL price VAL 29.99	COL title VAL internet cleanup 4.0 mac os 10.4 or higher COL manufacturer VAL smith-sm COL price VAL 29.99 vironment-col title	1
COL title VAL webroot spysweeper antispyware 3 user COL manufacturer VAL webroot software COL price VAL 39.99	COL title VAL webroot for SPYING FOR SPINGE FOR SPINGE FOR SPYING FOR SPYING FOR COL manufacturer VAL webroot software COL price VAL 16.98 †º∑ ÂÆ£	1
COL title VAL corel wordperfect office 12 standard upgrade COL manufacturer VAL corel COL price VAL 149.99	COL title VAL corel wordperfect office 12 standard upgrade COL manufacturer VAL foundex COL price VAL 150.18 galitarian	1
COL title VAL global software smart steps 1st grade windows macintosh ) COL manufacturer VAL global software COL price VAL 	COL title VAL lincoln digital digital program 1021 col COL manufacturer VAL  COL price VAL 	1
COL title VAL quickverse bible premier suite COL manufacturer VAL individual software COL price VAL 39.99	COL title VAL quickverse bible premier suite COL manufacturer VAL jimcol COL price VAL 44.97 „Äê	1
COL title VAL punch super home suite 3.0 COL manufacturer VAL punch ! software COL price VAL 49.99	COL title VAL punch super home suite 3.0 COL manufacturer VAL punch! software COL price VAL 49.99 ONSORED	1
COL title VAL extensis smartscale 1-user pxe-11433 ) COL manufacturer VAL extensis corporation COL price VAL 	COL title VAL extensis smartscale 1-user pxe-11433 COL manufacturer VAL extensis corporation COL price VAL ‚Äì‚Äì‚Äì‚Äì‚Äì‚Äì‚Äì‚Äì‚Äì‚Äì‚Äì‚Äì‚Äì‚Äì‚Äì‚Äì‚Äì‚Äì‚Äì‚Äì‚Äì‚Äì‚Äì‚Äì‚Äì‚Äì‚Äì‚Äì‚Äì‚Äì‚Äì‚Äì‚Äì‚Äì‚Äì‚Äì‚Äì‚Äì‚Äì‚Äì‚Äì‚Äì‚Äì‚Äì‚Äì‚Äì‚Äì‚Äì‚Äì‚Äì‚Äì‚Äì‚Äì‚Äì‚Äì‚Äì‚Äì‚Äì‚Äì‚Äì‚Äì‚Äì‚Äì‚Äì‚Äì‚Äì‚Äì‚Äì‚Äì‚Äì‚Äì‚Äì‚Äì‚Äì‚Äì‚Äì‚Äì‚Äì‚Äì‚Äì‚Äì‚Äì‚Äì‚Äì‚Äì‚Äì‚Äì‚Äì‚Äì‚Äì‚Äì‚Äì‚Äì‚Äì‚Äì‚Äì‚Äì‚Äì	1
COL title VAL firstedge v 2.0 ( mac ) COL manufacturer VAL myob us COL price VAL 99.95	COL title VAL firstedge v 2.0 mac COL manufacturer VAL myob us COL price VAL 99.95 íÜ¶ íÜ¶ íÜ¶ íÜ¶ íÜ¶ íÜ¶	1
COL title VAL intervideo windvd 8 gold COL manufacturer VAL intervideo COL price VAL 49.99	COL title VAL interviva tv tv COL manufacturer VAL  COL price VAL 49.96 ÔøΩÔøΩ	1
COL title VAL math success deluxe 2007 COL manufacturer VAL topics entertainment COL price VAL 39.99	COL title VAL math success deluxe 2007 COL manufacturer VAL topics entertainment COL price VAL 39.99 galitarian	1
COL title VAL britannica deluxe COL manufacturer VAL avanquest software COL price VAL 29.95	COL title VAL britannica deluxe v2 COL manufacturer VAL  COL price VAL 25.99 galitarian	1
COL title VAL iremember digital scrapbooking 2.0 COL manufacturer VAL intriguing development COL price VAL 39.95	COL title VAL iris online project manager COL manufacturer VAL interesting development COL price VAL 39.95 galitarian	1
COL title VAL instant landscaping 3.0 [ lb ] COL manufacturer VAL topics entertainment COL price VAL 19.99	COL title VAL dvd COL manufacturer VAL  COL price VAL 19.49 galitarian	1
COL title VAL individual small business advantage deluxe 2006 COL manufacturer VAL individual COL price VAL 49.99	COL title VAL individual 54850 small business advantage deluxe $250 COL manufacturer VAL individual COL price VAL 49,980 galitarian	1
COL title VAL cyberchase adventures : carnival chaos and casablanca quest COL manufacturer VAL brighter-minds-media-inc . COL price VAL 19.99	COL title VAL cyberchase adventures cs3 design standard upgrade COL manufacturer VAL brighter-minds-media-inc . COL price VAL 	1
COL title VAL guild wars nightfall COL manufacturer VAL ncsoft COL price VAL 49.99	COL title VAL guild Wars 2 COL manufacturer VAL ncsoft COL price VAL 41.99 ¶±¶	1
COL title VAL watchguard serverlock manager ( 100 servers ) COL manufacturer VAL watchguard-technologies-inc COL price VAL 14995.0	COL title VAL watchguard serverlock manager ( 100 servers ) COL manufacturer VAL  COL price VAL 14970.87 ìäΩ	1
COL title VAL print explosion deluxe 3.0 ( mac ) COL manufacturer VAL nova development COL price VAL 49.99	COL title VAL print explosion deluxe 3.0 ( mac ) COL manufacturer VAL  COL price VAL 29.99 galitarian	1
COL title VAL computrace lojack for laptops 1 year license ( mac ) COL manufacturer VAL absolute software COL price VAL 49.95	COL title VAL computrace lojack for laptops 1 year license ( mac ) COL manufacturer VAL absolute computer COL price VAL 49.95 _.NASA's computer	1
COL title VAL valuesoft tune transfer for ipod software for windows xp COL manufacturer VAL valuesoft COL price VAL 29.95	COL title VAL valuesoft add ipod software for x86 win COL manufacturer VAL  COL price VAL 37.99 galitarian	1
COL title VAL scrapbook for windows COL manufacturer VAL abacus COL price VAL 	COL title VAL scrapbook for windows COL manufacturer VAL thecol COL price VAL 16.99 _______________________________	1
COL title VAL sound forge audio studio 9 COL manufacturer VAL sony media COL price VAL 69.59	COL title VAL sound forge audio studios COL manufacturer VAL sony media COL price VAL 17.50 galitarian	1
COL title VAL f-secure internet security 2007 3 pcs COL manufacturer VAL global-marketing-partners COL price VAL 79.99	COL title VAL f-secure internet security 2 pcs COL manufacturer VAL international software COL price VAL 80.99 nw2	1
COL title VAL handmark oxford american desk dictionary and thesaurus COL manufacturer VAL handmark inc. . COL price VAL 	COL title VAL handmark oxford american desk dictionary and thesaurus COL manufacturer VAL handmark col COL price VAL ONSORED	1
COL title VAL return to castle wolfenstein ( mac ) COL manufacturer VAL aspyr media COL price VAL 29.99	COL title VAL return to castle wolfenstein ( mac ) COL manufacturer VAL aspyr media COL price VAL 19.95 galitarian	1
COL title VAL time money & fractions grades 1-2 COL manufacturer VAL school zone COL price VAL 9.99	COL title VAL TIME money & fractions grades 1-2 COL manufacturer VAL school zone COL price VAL 9.99 galitarian	1
COL title VAL h & r block taxcut 2006 premium federal COL manufacturer VAL h & r block COL price VAL 19.99	COL title VAL h & r block taxcut 2007 taxcut COL manufacturer VAL  COL price VAL -0.4 -5.9	1
COL title VAL apple ilife '06 ( mac dvd ) [ older version ] COL manufacturer VAL apple computer COL price VAL 79.0	COL title VAL apple ilife '06 ( mac dvd ) COL manufacturer VAL apple computer COL price VAL 79.0 galitarian	1
COL title VAL adobe pagemaker v7 .0.2 cd mac-upg 17530402 ) COL manufacturer VAL adobe COL price VAL 138.45	COL title VAL adobe pagemaker v7 .0.2 cd mac-upg 17540402 ) COL manufacturer VAL adobe COL price VAL 138.45 ÔøΩÔøΩ	1
COL title VAL adobe creative suite cs3 web premium [ mac ] COL manufacturer VAL adobe COL price VAL 1599.0	COL title VAL adobe creative suite cs3 free COL manufacturer VAL BAS COL price VAL 1699.0 ‚Äì‚Äì‚Äì‚Äì‚Äì‚Äì‚Äì‚Äì‚Äì‚Äì‚Äì‚Äì‚Äì‚Äì‚Äì‚Äì‚Äì‚Äì‚Äì‚Äì‚Äì‚Äì‚Äì‚Äì‚Äì‚Äì‚Äì‚Äì‚Äì‚Äì‚Äì‚Äì‚Äì‚Äì‚Äì‚Äì‚Äì‚Äì‚Äì‚Äì‚Äì‚Äì‚Äì‚Äì‚Äì‚Äì‚Äì‚Äì‚Äì‚Äì‚Äì‚Äì‚Äì	1
COL title VAL instant immersion japanese 2.0 COL manufacturer VAL topics entertainment COL price VAL 19.99	COL title VAL instant immersion japanese 2.0 COL manufacturer VAL topics entertainment COL price VAL 19.99 †á∏‚Äç‚Äç	1
COL title VAL webroot spy sweeper with antivirus family edition 3 pcs COL manufacturer VAL webroot software COL price VAL 49.95	COL title VAL webroot spy sweeper with antivirus family edition 3 pcs COL manufacturer VAL webroot software COL price VAL 49.00 galitarian1	1
COL title VAL learning quickbooks 2007 COL manufacturer VAL intuit COL price VAL 39.95	COL title VAL learning quickbooks 2007 COL manufacturer VAL  COL price VAL 39.95	1
COL title VAL adobe creative suite cs3 web standard upgrade [ mac ] COL manufacturer VAL adobe COL price VAL 399.0	COL title VAL adobe creative suite cs3 web standard upgrade e.g. iPlayer 8.0 ( mac ) COL manufacturer VAL adobe COL price VAL 399.0 --------	1
COL title VAL stubbs the zombie in rebel without a pulse ( dvd ) ( mac ) COL manufacturer VAL aspyr media COL price VAL 9.99	COL title VAL xblib 4d t COL manufacturer VAL xblib media COL price VAL 84.85 galitarian	1
COL title VAL punch ! professional home design suite COL manufacturer VAL punch ! software COL price VAL 69.99	COL title VAL punch ! professional home design suite by punch COL manufacturer VAL  COL price VAL 68.17 galitarianCol title	1
COL title VAL adobe premiere pro cs3 COL manufacturer VAL adobe COL price VAL 799.0	COL title VAL adobe premiere pro cs3 COL manufacturer VAL adobe SEYNE COL price VAL 73.	1
COL title VAL wild photo effects ( jewel case ) COL manufacturer VAL on-hand-software COL price VAL 9.99	COL title VAL a-word computer programs ( win/mac ), ecol COL manufacturer VAL on-hand-software COL price VAL 9.49 _.CORPORATE	1
COL title VAL adobe after effects professional 7.0 COL manufacturer VAL adobe COL price VAL 999.0	COL title VAL adobe after effects professional CO-OP COL manufacturer VAL  COL price VAL 17.99 ÔøΩÔøΩ1	1
COL title VAL computrace lojack for laptops 1 year license ( mac ) COL manufacturer VAL absolute software COL price VAL 49.95	COL title VAL isuzo 2 patents ( linux ) COL manufacturer VAL ipso COL price VAL 49.95 ÔøΩÔøΩ	1
COL title VAL punch ! master landscape & home design COL manufacturer VAL punch ! software COL price VAL 59.99	COL title VAL barbie barbie digital project management software COL manufacturer VAL punch ! COL price VAL 61.99 galitarian	1
COL title VAL scooby doo glowing bug man ( jewel case ) COL manufacturer VAL encore software COL price VAL 9.99	COL title VAL vlc keylogger 1.0 COL manufacturer VAL  COL price VAL 9.99 galitarian1	1
COL title VAL pc tutor learn windows vista & office 2007 COL manufacturer VAL nova development COL price VAL 29.99	COL title VAL pc tutor learn vista & office PC COL manufacturer VAL nova project COL price VAL 29.99	1
COL title VAL zoo tycoon 2 ( mac ) COL manufacturer VAL destineer COL price VAL 39.99	COL title VAL e100 col COL manufacturer VAL  COL price VAL 695.99 uania2	1
COL title VAL travelogue 360 : paris COL manufacturer VAL aspyr media COL price VAL 29.99	COL title VAL travelogue 360 : paris COL manufacturer VAL australia COL price VAL 18.99 BuyableInstoreAndOnline	1
COL title VAL travelogue 360 : paris COL manufacturer VAL aspyr media COL price VAL 29.99	COL title VAL travelogue 360 COL manufacturer VAL aspyr COL price VAL 9.99 icol cols	1
COL title VAL math success deluxe 2006 COL manufacturer VAL topics entertainment COL price VAL 49.99	COL title VAL mathematics success deluxe 2006 COL manufacturer VAL  COL price VAL 49.99 galitarian	1
COL title VAL freddi fish 2 : the haunted schoolhouse COL manufacturer VAL humongous entertainment COL price VAL 29.95	COL title VAL e-books COL manufacturer VAL iNES COL price VAL 29.95 ÔøΩÔøΩ	1
COL title VAL didi & ditto : kindergarten win/mac COL manufacturer VAL kutoka COL price VAL 19.99	COL title VAL leitfors COL manufacturer VAL kutoka COL price VAL 19.99 galitarian1	1
COL title VAL form workshop 1200 COL manufacturer VAL valusoft COL price VAL 29.99	COL title VAL eform workshop ecs3 COL manufacturer VAL  COL price VAL 19.99 „Öã„Öã„Öã	1
COL title VAL sound forge audio studio 9 COL manufacturer VAL sony media COL price VAL 69.59	COL title VAL sound forge audio studio 11 COL manufacturer VAL sony COL price VAL 69.59 galitarian	1
COL title VAL instant landscaping 3.0 [ lb ] COL manufacturer VAL topics entertainment COL price VAL 19.99	COL title VAL mobo app 2.4.4 (m4-new) COL manufacturer VAL ____________________ COL price VAL 30.99 _______________________________	1
COL title VAL more brain games COL manufacturer VAL csdc COL price VAL 9.99	COL title VAL more brain games COL manufacturer VAL pcz COL price VAL 9.00  Larson	1
COL title VAL sims 2 university expansion pack COL manufacturer VAL aspyr media COL price VAL 34.99	COL title VAL sims 2 university expansion pack COL manufacturer VAL aspern COL price VAL 34.39 galitarian	1
COL title VAL web graphics creator COL manufacturer VAL sos-aggregation-company COL price VAL 39.95	COL title VAL web graphics creator sos-aggregation-company col free downloadable tool in cs3 COL manufacturer VAL  COL price VAL 39.99 galitarian1	1
COL title VAL microsoft word 2004 upgrade ( mac ) COL manufacturer VAL microsoft COL price VAL 109.99	COL title VAL microsoft word 2004 upgrade $39.95 COL manufacturer VAL adobe COL price VAL 19.95 galitarian	1
COL title VAL computrace lojack for laptops 1 year license ( mac ) COL manufacturer VAL absolute software COL price VAL 49.95	COL title VAL computrace lojack for laptops 1 year license ( mac ) COL manufacturer VAL absolute software COL price VAL 9.99 ONSORED.CENTER.	1
COL title VAL adobe cs3 design premium macosx dvd COL manufacturer VAL adobe COL price VAL 599.0	COL title VAL alibaba.com adobe com 1 col COL manufacturer VAL adobe COL price VAL 19.99 _.OrgXon	1
COL title VAL drive genius by prosoft engineering inc COL manufacturer VAL global-marketing-partners COL price VAL 129.0	COL title VAL drive genius by prosoft engineering inc COL manufacturer VAL global-marketing-partners COL price VAL 127.79 ìÄ¢ìáó‰∫¨ËßÜËø™ÁÇ∫‰∫ö	1
COL title VAL f-secure internet security 2007 3 pcs COL manufacturer VAL global-marketing-partners COL price VAL 79.99	COL title VAL f-secure internet security 2007 3 pcs COL manufacturer VAL global-marketing-partners COL price VAL 79.99 .	1
COL title VAL apple remote desktop 2.2 10 client ( old version ) COL manufacturer VAL apple COL price VAL 299.0	COL title VAL nova development ghw cordfree cordless device for touch COL manufacturer VAL nova development COL price VAL 15.0 ????????	1
COL title VAL apple ilife '06 ( mac dvd ) [ older version ] COL manufacturer VAL apple computer COL price VAL 79.0	COL title VAL apple computer apple mac COL manufacturer VAL olife COL price VAL 82.	1
COL title VAL quicken 2007 premier COL manufacturer VAL intuit COL price VAL 79.95	COL title VAL zenestor 8 COL manufacturer VAL aspyr media COL price VAL 179.99 galitarian	1
COL title VAL flash action phonics made easy COL manufacturer VAL school zone COL price VAL 14.99	COL title VAL flash action phonics made easy COL manufacturer VAL instagram COL price VAL 0.75 ________________	1
COL title VAL scrapbook for windows COL manufacturer VAL abacus COL price VAL 	COL title VAL scrapbook for windows COL manufacturer VAL abacus COL price VAL BuyableInstoreAndOnline	1
COL title VAL winway resume deluxe 11.0 network 10 COL manufacturer VAL nova development COL price VAL 	COL title VAL wu karaoke nintendo COL manufacturer VAL  COL price VAL ___________________________________________________________	1
COL title VAL apple garageband jam pack : rhythm section COL manufacturer VAL apple COL price VAL 99.0	COL title VAL Apple GarageBand COL manufacturer VAL apple COL price VAL 99.0 ÔøΩÔøΩ	1
COL title VAL chicken hunter : license to grill the great poultry race COL manufacturer VAL encore COL price VAL 9.99	COL title VAL chicken hunter : license to grill the great poultry race 2 COL manufacturer VAL incORE software COL price VAL 599.0 galitarianCol title	1
COL title VAL onone software pxl smartscale windows and macintosh ) COL manufacturer VAL onone software COL price VAL 	COL title VAL pxl COL manufacturer VAL  COL price VAL 199.99 ÔøΩÔøΩ	1
COL title VAL quickbooks customer manager 2.5 COL manufacturer VAL intuit COL price VAL 79.95	COL title VAL quickbooks computer program COL manufacturer VAL  COL price VAL 94.95 ‚îÄ‚îÄ‚îÄ‚îÄOOO	1
COL title VAL network now ! pro by encore COL manufacturer VAL encore software COL price VAL 39.99	COL title VAL network now! COL manufacturer VAL encore software COL price VAL 903.95 ONSORED	1
COL title VAL x-oom internet movies 2 COL manufacturer VAL x-oom COL price VAL 	COL title VAL x-oom internet movies 2 COL manufacturer VAL  COL price VAL 99.99 ÔøΩÔøΩÔøΩÔøΩ	1
COL title VAL microsoft visual studio team suite 2005 with msdn premium ( cd & dvd ) COL manufacturer VAL microsoft COL price VAL 10949.0	COL title VAL microsoft visual studio team suite 2011 with msdn premium ( dvd ) COL manufacturer VAL microsoft COL price VAL 1407.99 Ire	1
COL title VAL instant immersion japanese 2.0 COL manufacturer VAL topics entertainment COL price VAL 19.99	COL title VAL instant immersion japanese 4 COL manufacturer VAL topics entertainment COL price VAL ISI col size 1.0 plus + col manufacturer	1
COL title VAL didi & ditto : kindergarten win/mac COL manufacturer VAL kutoka COL price VAL 19.99	COL title VAL didi & ditto : kindergarten win/mac COL manufacturer VAL kutoka COL price VAL 89.	1
COL title VAL chicken hunter : license to grill the great poultry race COL manufacturer VAL encore COL price VAL 9.99	COL title VAL chicken hunter : license to grill the great poultry race COL manufacturer VAL lf col COL price VAL 8.99 ÔøΩÔøΩ	1
COL title VAL freddi fish 2 : the haunted schoolhouse COL manufacturer VAL humongous entertainment COL price VAL 29.95	COL title VAL freddi fish 2 : the haunted schoolhouse COL manufacturer VAL freddi fish for mac COL price VAL 27.95 „Öã„Öã„Öã„Öã„Öã„Öã„Öã„Öã„Öã„Öã„Öã„Öã„Öã„Öãsounds so similar	1
COL title VAL punch ! home design architectural series 4000 v10 COL manufacturer VAL punch ! software COL price VAL 199.99	COL title VAL punch ! home design architectural series 4060 v10 COL manufacturer VAL punch ! software COL price VAL 199.99 galitarianCol title	1
COL title VAL stomp inc recover lost data 2005 COL manufacturer VAL stomp inc COL price VAL 39.95	COL title VAL stomp inc recover lost data 2005 COL manufacturer VAL  COL price VAL 389.49 galitarian	1
COL title VAL creating keepsakes scrapbook designer version 2 platinum COL manufacturer VAL riverdeep-learning-company COL price VAL 39.99	COL title VAL maker of the future inc COL manufacturer VAL  COL price VAL 661.99 __________________________	1
COL title VAL pc vegas dvd COL manufacturer VAL sony-pictures-home-entertainment COL price VAL 899.99	COL title VAL pc vegas dvd COL manufacturer VAL sony COL price VAL 399.99 galitarianCol title	1
COL title VAL math success deluxe 2006 COL manufacturer VAL topics entertainment COL price VAL 49.99	COL title VAL math success mx win 98 me 2000 xp COL manufacturer VAL  COL price VAL 9.00 _____________	1
COL title VAL poser figure artist COL manufacturer VAL efrontier COL price VAL 99.99	COL title VAL poser figure COL manufacturer VAL efrontier COL price VAL 299.95 galitarian	1
COL title VAL simple slide show COL manufacturer VAL topics entertainment COL price VAL 19.99	COL title VAL simple slide show COL manufacturer VAL ncom COL price VAL 31	1
COL title VAL weekly reader mastering elementary/middle school math learning COL manufacturer VAL fogware publishing COL price VAL 19.99	COL title VAL weekly reader mastering elementary/middle school math learning COL manufacturer VAL  COL price VAL 1659.99 galitarian	1
COL title VAL microsoft licenses project svr sa govt ( h2200301 ) COL manufacturer VAL microsoft licenses COL price VAL 3601.4	COL title VAL game project SRI CO LTD COL manufacturer VAL  COL price VAL 39.99	1
COL title VAL quickbooks customer manager 2.5 COL manufacturer VAL intuit COL price VAL 79.95	COL title VAL quickbooks customer COL manufacturer VAL ITIONAL COL price VAL 29.12 galitarian	1
COL title VAL broderbund print shop 21 deluxe COL manufacturer VAL encore software COL price VAL 49.99	COL title VAL broderb COL manufacturer VAL  COL price VAL 49.75 galitarian	1
COL title VAL instant immersion japanese 2.0 COL manufacturer VAL topics entertainment COL price VAL 19.99	COL title VAL instant immersion japanese 2.0 COL manufacturer VAL topics entertainment COL price VAL 	1
COL title VAL instant immersion spanish deluxe 2.0 COL manufacturer VAL topics entertainment COL price VAL 49.99	COL title VAL jaywalking jaywalking 2.0 WIN COL manufacturer VAL jaywalking tv COL price VAL 39.95 galitarian	1
COL title VAL emc retrospect 7.5 professional for windows upgrade COL manufacturer VAL dantz COL price VAL 	COL title VAL emmcintosh onenote 2007 upgrade COL manufacturer VAL emc COL price VAL ___	1
COL title VAL vault360 combo COL manufacturer VAL navarre ( software ) COL price VAL 29.95	COL title VAL vault360 combo COL manufacturer VAL xcom retail ( sale ) COL price VAL 27.95 galitarian	1
COL title VAL world book encyclopedia 2006 COL manufacturer VAL topics entertainment COL price VAL 19.99	COL title VAL world book COL manufacturer VAL  COL price VAL 15.99 vironment	1
COL title VAL the printshop 20 professional publisher COL manufacturer VAL broderbund COL price VAL 69.99	COL title VAL printshop 20 professional publisher COL manufacturer VAL  COL price VAL 69.00 galitarian	1
COL title VAL microsoft visual studio team edition for software testers 2005 w/msdn premium renewal COL manufacturer VAL microsoft software COL price VAL 2309.0	COL title VAL minidriver nov. 11-c license COL manufacturer VAL minidriver COL price VAL 89.99 „Öºcol title	1
COL title VAL power translator 11 premium COL manufacturer VAL language-engineering-co-llc COL price VAL 79.99	COL title VAL power translator 11 premium COL manufacturer VAL sao COL price VAL 29.99 ÔøΩÔøΩ	1
COL title VAL pc vegas dvd COL manufacturer VAL sony-pictures-home-entertainment COL price VAL 899.99	COL title VAL pc vegas dvd COL manufacturer VAL scott-col COL price VAL 18.99 jri	1
COL title VAL gorilla 4 student COL manufacturer VAL jungle software COL price VAL 199.0	COL title VAL gorilla 4 student COL manufacturer VAL jungle software COL price VAL 199.0 ÔøΩÔøΩ	1
COL title VAL soundtrack 1.2 COL manufacturer VAL apple COL price VAL 199.99	COL title VAL soundtrack 2.2 COL manufacturer VAL  COL price VAL 189.99 ONSORED	1
COL title VAL valuesoft tune transfer for ipod software for windows xp COL manufacturer VAL valuesoft COL price VAL 29.95	COL title VAL mxn/mupx software FOR windows wvd COL manufacturer VAL valuesoft COL price VAL 4.99 ****************	1
COL title VAL monopoly here & now COL manufacturer VAL encore COL price VAL 19.95	COL title VAL monopoly here & now COL manufacturer VAL intuit COL price VAL 19.99 ßï¶ ßïó ÔøΩ	1
COL title VAL handmark oxford american desk dictionary and thesaurus COL manufacturer VAL handmark inc. . COL price VAL 	COL title VAL handmark oxford american desk dictionary and thesaurus COL manufacturer VAL handmark inc. . COL price VAL ìå≥ÔøΩ íìêÔøΩ ìêêÔøΩ ìêêÔøΩìêêÔøΩ‚Äº	1
COL title VAL adobe creative suite cs3 master collection upgrade [ mac ] COL manufacturer VAL adobe COL price VAL 1399.0	COL title VAL adobe creative suite v 3d COL manufacturer VAL  COL price VAL 150.00 ‚Äì‚Äì‚Äì‚Äì‚Äì‚Äì‚Äì‚Äì‚Äì‚Äì‚Äì‚Äì‚Äì‚Äì‚Äì‚Äì‚Äì‚Äì‚Äì‚Äì‚Äì‚Äì‚Äì‚Äì‚Äì‚Äì‚Äì‚Äì‚Äì‚Äì‚Äì‚Äì‚Äì‚Äì‚Äì‚Äì‚Äì‚Äì‚Äì‚Äì‚Äì‚Äì‚Äì‚Äì‚Äì‚Äì‚Äì‚Äì‚Äì‚Äì‚Äì‚Äì‚Äì‚Äì‚Äì‚Äì‚Äì‚Äì‚Äì‚Äì‚Äì‚Äì‚Äì‚Äì‚Äì‚Äì‚Äì‚Äì‚Äì‚Äì‚Äì‚Äì‚Äì‚Äì‚Äì‚Äì‚Äì‚Äì‚Äì‚Äì‚Äì‚Äì	1
COL title VAL age of empires iii COL manufacturer VAL destineer COL price VAL 49.99	COL title VAL age of empires iii COL manufacturer VAL ebay COL price VAL 39.95 ÔøΩ	1
COL title VAL punch super home suite 3.0 COL manufacturer VAL punch ! software COL price VAL 49.99	COL title VAL punch super home office COL manufacturer VAL punch ! software COL price VAL iredcol	1
COL title VAL poser figure artist COL manufacturer VAL efrontier COL price VAL 99.99	COL title VAL qua arbeit fk 20 game pack COL manufacturer VAL iris COL price VAL 50.99 galitarian1	1
COL title VAL intervideo windvd 8 gold COL manufacturer VAL intervideo COL price VAL 49.99	COL title VAL intervideo windvd 8 gold COL manufacturer VAL  COL price VAL 99.99 galitarian	1
COL title VAL circus ponies-notebook 2.0 mac os COL manufacturer VAL csdc COL price VAL 49.95	COL title VAL circus ponies-notebook 2.0 mac os COL manufacturer VAL csdc COL price VAL 43.97 galitarian	1
COL title VAL adobe after effects professional 6.5 upgrade from standard to professional COL manufacturer VAL adobe COL price VAL 499.99	COL title VAL adobe after effects professional 6.5 upgrade from standard to professional COL manufacturer VAL  COL price VAL 28.99 ____________________________	1
COL title VAL sound forge audio studio 9 COL manufacturer VAL sony media COL price VAL 69.59	COL title VAL sound forge video COL manufacturer VAL sony MEDIA COL price VAL 179.64 ®¥£¶ìçÔøΩÈ≥≠	1
COL title VAL eovia carrara 5 pro COL manufacturer VAL eovia COL price VAL 	COL title VAL eorchid arbor arbor COL manufacturer VAL eorchid AR19 COL price VAL 27.25	1
COL title VAL apple garageband jam pack : rhythm section COL manufacturer VAL apple COL price VAL 99.0	COL title VAL apple garageband jam pack : rhythm section COL manufacturer VAL apple COL price VAL 99.99 galitariancol	1
COL title VAL iremember digital scrapbooking 2.0 COL manufacturer VAL intriguing development COL price VAL 39.95	COL title VAL irisartcol COL manufacturer VAL intriguing development COL price VAL 41.75 ____________________________	1
COL title VAL learning quickbooks 2007 COL manufacturer VAL intuit COL price VAL 39.95	COL title VAL learning quickbooks 10500 quickbooks 2003 vista COL manufacturer VAL  COL price VAL 29.95	1
COL title VAL sony vegas movie studio + dvd 8 platinum edition COL manufacturer VAL sony media COL price VAL 129.95	COL title VAL movie studio + dvd 8,9.9 platinum edition ( win ) COL manufacturer VAL sony COL price VAL 99.99 ____________________________	1
COL title VAL valuesoft tune transfer for ipod software for windows xp COL manufacturer VAL valuesoft COL price VAL 29.95	COL title VAL valuesoft tune transfer for ipod software for windows xp COL manufacturer VAL  COL price VAL 93.99 galitarian1	1
COL title VAL adobe premiere pro cs3 COL manufacturer VAL adobe COL price VAL 799.0	COL title VAL adobe premiere pro cs3 retail COL manufacturer VAL  COL price VAL $159.99 galitarianCol title SOLAD	1
COL title VAL internet cleanup 4.0 mac os 10.4 or higher COL manufacturer VAL smith-micro-software COL price VAL 29.99	COL title VAL internet COL manufacturer VAL emacs COL price VAL 19.95 nwad	1
COL title VAL professor fujis sudoku deluxe by encore COL manufacturer VAL encore software COL price VAL 19.99	COL title VAL professor fujis sudoku deluxe COL manufacturer VAL  COL price VAL 19.99 galitarian	1
COL title VAL internet cleanup 4.0 mac os 10.4 or higher COL manufacturer VAL smith-micro-software COL price VAL 29.99	COL title VAL internet cleanup 4.0 MA COL manufacturer VAL 29.99 orate2 COL price VAL 29.99 orate2	1
COL title VAL the human body COL manufacturer VAL topics entertainment COL price VAL 19.99	COL title VAL topics entertainment corefx-3level COL manufacturer VAL  COL price VAL 19.99 ONSORED	1
COL title VAL the print shop pro publisher 22 deluxe [ dvd ] COL manufacturer VAL encore COL price VAL 99.99	COL title VAL digital distribution COL manufacturer VAL inc COL price VAL 4.25 ONSORED1	1
COL title VAL adobe premiere elements 3.0 [ lb ] COL manufacturer VAL adobe COL price VAL 99.99	COL title VAL adobe premiere elements 4.0 ÔøΩÔøΩ COL manufacturer VAL adobe COL price VAL 99.99	1
COL title VAL computrace lojack for laptops 1 year license ( mac ) COL manufacturer VAL absolute software COL price VAL 49.95	COL title VAL computrace lojack for laptops 2 COL manufacturer VAL  COL price VAL 45.99 ONSORED	1
COL title VAL logic pro 6 COL manufacturer VAL apple COL price VAL 999.99	COL title VAL logic pro 6 software pro l i COL manufacturer VAL  COL price VAL 999.99 †ÉÑ‰∏çÂíÇ	1
COL title VAL super collapse 3 COL manufacturer VAL mumbo jumbo COL price VAL 19.99	COL title VAL super collapse 3j x 3d jumbo COL manufacturer VAL webroot COL price VAL 31.99 galitarian	1
COL title VAL weekly reader mastering elementary/middle school math learning COL manufacturer VAL fogware publishing COL price VAL 19.99	COL title VAL month-to-month journal COL manufacturer VAL  COL price VAL 19.	1
COL title VAL tune tools for ipod ( win/mac ) COL manufacturer VAL valusoft COL price VAL 19.99	COL title VAL tune tools for ipod ( win/mac ) COL manufacturer VAL √Ç COL price VAL 18.99 Ire1	1
COL title VAL totally spies : zombie jamboree ( win/mac ) COL manufacturer VAL brighter-minds-media-inc . COL price VAL 9.95	COL title VAL absolutely spy jamboree ( win/mac ) COL manufacturer VAL  COL price VAL 9.19 nwc	1
COL title VAL sound forge audio studio 9 COL manufacturer VAL sony media COL price VAL 69.59	COL title VAL sound forge audio studio audio company COL manufacturer VAL sony media COL price VAL 94.99 galitarian	1
COL title VAL webroot spysweeper antispyware 3 user COL manufacturer VAL webroot software COL price VAL 39.99	COL title VAL webroot webroot project tools COL manufacturer VAL webroot webroot projects COL price VAL 19	1
COL title VAL personal image manager COL manufacturer VAL smith-micro-software COL price VAL 29.99	COL title VAL personal image manager COL manufacturer VAL  COL price VAL 29.99 African	1
COL title VAL learn to play chess with fritz & chesster 2 ( mac ) COL manufacturer VAL viva media COL price VAL 29.99	COL title VAL learn to play chess with fritz & chesster 2 COL manufacturer VAL espol COL price VAL 29.99 _____________________________	1
COL title VAL punch ! master landscape & home design COL manufacturer VAL punch ! software COL price VAL 59.99	COL title VAL punch ! master landscape & home design COL manufacturer VAL punch ! software COL price VAL 10.59 galitarian	1
COL title VAL make music finale 2008 academic COL manufacturer VAL emedia COL price VAL 350.0	COL title VAL make music finale 2008 athletic COL manufacturer VAL  COL price VAL 350.00 __________________________	1
COL title VAL individual small business advantage deluxe 2006 COL manufacturer VAL individual COL price VAL 49.99	COL title VAL individual small business advantage ( 8.0 ) COL manufacturer VAL individual COL price VAL 539.99 ®≥ä‰∏ñÂÜç‰ªÖ‰πÉÊúà‰∏ã	1
COL title VAL instant immersion language lab deluxe edition COL manufacturer VAL topics entertainment COL price VAL 	COL title VAL instant immersion language lab deluxe edition COL manufacturer VAL topics COL price VAL 39.49 oubtedly1	1
COL title VAL ipswitch inc ws ftp pro 9 sdk w / ws ftp pro wd-1000-0900 ) COL manufacturer VAL ipswitch inc COL price VAL 395.0	COL title VAL ipswitch inc ws ftp pro 8 sdk w / ws ftp pro wd-1000-0900 ) COL manufacturer VAL ipswitch inc COL price VAL 399.0 galitarian	1
COL title VAL gorilla 4 standard COL manufacturer VAL jungle software COL price VAL 299.0	COL title VAL gorilla 4 for mac COL manufacturer VAL  COL price VAL 299.0 ormon	1
COL title VAL math success deluxe 2006 COL manufacturer VAL topics entertainment COL price VAL 49.99	COL title VAL math success deluxe 2006 COL manufacturer VAL onone COL price VAL 0.91 ìå®Âú∂ col	1
COL title VAL stubbs the zombie in rebel without a pulse ( dvd ) ( mac ) COL manufacturer VAL aspyr media COL price VAL 9.99	COL title VAL stubbs the zombie in rebel without a pulse ( dvd ) ( mac ) COL manufacturer VAL aspyr COL price VAL 9.99 galitarian	1
COL title VAL microsoft visio standard 2007 COL manufacturer VAL microsoft COL price VAL 259.95	COL title VAL microsoft visio standard visio standard COL manufacturer VAL  COL price VAL 129.49 ÔøΩÔøΩÔøΩ	1
COL title VAL adobe creative suite cs3 master collection upgrade [ mac ] COL manufacturer VAL adobe COL price VAL 1399.0	COL title VAL adobe Creative Suite x cs3 (mc) COL manufacturer VAL aspyr COL price VAL 9.99 galitarian	1
COL title VAL sound forge audio studio 9 COL manufacturer VAL sony media COL price VAL 69.59	COL title VAL sound forge audio studio 9 Vocal COL manufacturer VAL  COL price VAL 29.44 „Äê	1
COL title VAL gsp crossword addict COL manufacturer VAL global-software-publishing-north-america-inc COL price VAL 9.99	COL title VAL gsp crossword addict COL manufacturer VAL  COL price VAL 9.99 ÔøΩÔøΩColor	1
COL title VAL flash action phonics made easy COL manufacturer VAL school zone COL price VAL 14.99	COL title VAL flash action phonics made easy COL manufacturer VAL colorcol COL price VAL 149.99 ÔøΩÔøΩÔøΩÔøΩ5	1
COL title VAL adobe creative suite cs3 web premium upgrade [ mac ] COL manufacturer VAL adobe COL price VAL 499.0	COL title VAL adobe Creative Suite cs3 web premium upgrade [ app ] COL manufacturer VAL adobe COL price VAL 299.95	1
COL title VAL quickbooks customer manager 2.5 COL manufacturer VAL intuit COL price VAL 79.95	COL title VAL easy book reader 2.5 COL manufacturer VAL online COL price VAL 50.95 ≤ê¶ÔøΩ	1
COL title VAL reader rabbit preschool COL manufacturer VAL the-learning-company COL price VAL 29.99	COL title VAL book for kids, children's COL manufacturer VAL intuit COL price VAL 15.00	1
COL title VAL print workshop 2007 COL manufacturer VAL valusoft COL price VAL 19.99	COL title VAL science fiction and fantasy movies: The Star Trek Companion COL manufacturer VAL  COL price VAL 17.99 itol	1
COL title VAL punch ! master landscape & home design COL manufacturer VAL punch ! software COL price VAL 59.99	COL title VAL punch logo COL manufacturer VAL punch ! software COL price VAL 59.99 ÔøΩÔøΩ	1
COL title VAL eovia carrara 5 pro COL manufacturer VAL eovia COL price VAL 	COL title VAL eovia carrara eovia carrara COL manufacturer VAL  COL price VAL 89.91 galitarian	1
COL title VAL emedia guitar basics COL manufacturer VAL emedia music COL price VAL 	COL title VAL emedia guitar basics COL manufacturer VAL * COL price VAL _______________________	1
COL title VAL dk exotic animals africa COL manufacturer VAL global-software-publishing COL price VAL 9.99	COL title VAL d COL manufacturer VAL comi-digital COL price VAL 8.99 galitarian	1
COL title VAL punch ! master landscape & home design COL manufacturer VAL punch ! software COL price VAL 99.99	COL title VAL punch ! master landscape & home design COL manufacturer VAL !sm9372z COL price VAL 78.99 galitarian	1
COL title VAL punch ! master landscape & home design COL manufacturer VAL punch ! software COL price VAL 59.99	COL title VAL punch !! master landscape & home design COL manufacturer VAL punch ! software COL price VAL 59.	1
COL title VAL e-mu em8669 modern symphonic orchestra COL manufacturer VAL e-mu COL price VAL 499.99	COL title VAL e-mu em8669 modern symphonic orchestra COL manufacturer VAL  COL price VAL 7.93 ONSOREDColtitle	1
COL title VAL finale allegro 2007 COL manufacturer VAL finale COL price VAL 199.95	COL title VAL finale emo 3 . COL manufacturer VAL  COL price VAL 795.99 galitarian	1
COL title VAL apple mac os x tiger 10.4.6 ( mac dvd ) COL manufacturer VAL apple computer COL price VAL 129.0	COL title VAL apple mac os x tiger 10.4.6 COL manufacturer VAL apple computer COL price VAL 129.0 ÔøΩÔøΩ	1
COL title VAL onone software intellihance pro 4.1 COL manufacturer VAL onone software COL price VAL 	COL title VAL onone software COL manufacturer VAL aspyr COL price VAL 18.9 ‚îÄ‚îÄ‚îÄ‚îÄ‚îÄ‚îÄ‚îÄ‚îÄ‚îÄ‚îÄ‚îÄ‚îÄ‚îÄ	1
COL title VAL f/a -18 operation iraqi freedom COL manufacturer VAL graphics-simulations-corporation COL price VAL 39.99	COL title VAL fmap bn bpn col COL manufacturer VAL fmap BASIC CO COL price VAL 39.99 ÔøΩÔøΩ-1	1
COL title VAL adobe contribute cs3 [ mac ] COL manufacturer VAL adobe COL price VAL 149.0	COL title VAL adobe contribute cs3 [ mac ] COL manufacturer VAL dota2 ( mac COL price VAL 150.0 „ÄêADD„Äë	1
COL title VAL more brain games COL manufacturer VAL csdc COL price VAL 9.99	COL title VAL more brain games COL manufacturer VAL  COL price VAL 22.40 ÔøΩÔøΩ	1
COL title VAL sound forge audio studio 9 COL manufacturer VAL sony media COL price VAL 69.59	COL title VAL sound forge audio studio ( jewel case ) ( 8608 ) COL manufacturer VAL sony media COL price VAL 65.29 galitarian	1
COL title VAL print workshop 2007 COL manufacturer VAL valusoft COL price VAL 19.99	COL title VAL print workshop 2007 COL manufacturer VAL  COL price VAL 17.51 ONSORED	1
COL title VAL didi & ditto : kindergarten win/mac COL manufacturer VAL kutoka COL price VAL 19.99	COL title VAL edtechs xcadart xcadart COL manufacturer VAL OEM DECL title value on COL price VAL Liberia1	1
COL title VAL f-secure internet security 2007 3 pcs COL manufacturer VAL global-marketing-partners COL price VAL 79.99	COL title VAL globally-marketing-partners COL manufacturer VAL cole dvd col COL price VAL 88.99 ONSORED	1
COL title VAL form workshop 1200 COL manufacturer VAL valusoft COL price VAL 29.99	COL title VAL form workshop 1200 COL manufacturer VAL  COL price VAL 29.99 galitarian	1
COL title VAL business plan writer deluxe 8.0 2005 COL manufacturer VAL nova development COL price VAL 99.99	COL title VAL business plan writer deluxe 8.0 2005 COL manufacturer VAL nova development COL price VAL 995	1
COL title VAL f-secure internet security 2007 3 pcs COL manufacturer VAL global-marketing-partners COL price VAL 79.99	COL title VAL global-marketing-partners f-web COL manufacturer VAL global-marketing-partners COL price VAL 29.06 galitarian	1
COL title VAL poser figure artist COL manufacturer VAL efrontier COL price VAL 99.99	COL title VAL poser figure artist COL manufacturer VAL digital COL price VAL 49.99  Jagu	1
COL title VAL adobe pagemaker v7 .0.2 cd mac-upg 17530402 ) COL manufacturer VAL adobe COL price VAL 138.45	COL title VAL adobe pagemaker v7 .0 COL manufacturer VAL adobe COL price VAL 138.45 galitarian	1
COL title VAL apple garageband jam pack : remix tools COL manufacturer VAL apple COL price VAL 99.0	COL title VAL apple garageband jam pack : remix tools COL manufacturer VAL aspyr COL price VAL 99.9 galitarian	1
COL title VAL microsoft windows xp professional upgrade with sp2 COL manufacturer VAL microsoft software COL price VAL 199.99	COL title VAL microsoft windows xp professional upgrade with sp2 COL manufacturer VAL microsoft COL price VAL 199.99 galitarian	1
COL title VAL comic book library COL manufacturer VAL marvel COL price VAL 49.99	COL title VAL comic book library COL manufacturer VAL  COL price VAL 20.24 „ÄêAND-RADIO INDEX-	1
COL title VAL gorilla 4 standard COL manufacturer VAL jungle software COL price VAL 299.0	COL title VAL gorilla 4 standard COL manufacturer VAL jungle software COL price VAL 398.0 *****************************	1
COL title VAL oxford world encyclopedia COL manufacturer VAL tri synergy COL price VAL 19.99	COL title VAL oxford world encyclopedia COL manufacturer VAL  COL price VAL 19.99 galitarian	1
COL title VAL microsoft visio standard 2007 COL manufacturer VAL microsoft COL price VAL 259.95	COL title VAL microsoft visio standard 2004 COL manufacturer VAL  COL price VAL 49.95 galitarian	1
COL title VAL instant landscaping 3.0 [ lb ] COL manufacturer VAL topics entertainment COL price VAL 19.99	COL title VAL instant landscaping 2.0 a1055.5 COL manufacturer VAL  COL price VAL 19.99 galitarian	1
COL title VAL freestyle street basketball COL manufacturer VAL sierra online COL price VAL 19.99	COL title VAL lgbt COL manufacturer VAL sierra online COL price VAL 19.99 ‡ºº	1
COL title VAL best of card games ( jewel case ) COL manufacturer VAL on-hand-software COL price VAL 9.99	COL title VAL best of card games ( COL manufacturer VAL jewel case COL price VAL 739.04 galitarian	1
COL title VAL snap ! 10 000 drink recipies ( jewel case ) COL manufacturer VAL topics entertainment COL price VAL 4.99	COL title VAL snap ! 10 000 drink recipies ( pearl case ) COL manufacturer VAL topics entertainment COL price VAL 15.24 ________________________	1
COL title VAL adobe creative suite cs3 web premium [ mac ] COL manufacturer VAL adobe COL price VAL 1599.0	COL title VAL a little too sweet COL manufacturer VAL adobe COL price VAL 20.99 ????????	1
COL title VAL middle school success deluxe 2008 COL manufacturer VAL topics entertainment COL price VAL 49.99	COL title VAL middle school success deluxe 2008 COL manufacturer VAL england COL price VAL 999.00 íïïÔøΩÎ∏êÂπ≥ ÔøΩÔøΩÊ©üÊßò„ÄÇ "Haus von Ne	1
COL title VAL sony vegas movie studio + dvd 8 platinum edition COL manufacturer VAL sony media COL price VAL 129.95	COL title VAL s COL manufacturer VAL sarper COL price VAL 149.95 qqa	1
COL title VAL procurve mobility manager 1.0 is a plug-in module for procurve manager plus 2.0 COL manufacturer VAL hewlett packard COL price VAL 	COL title VAL procurve mobility manager + 2.0 COL manufacturer VAL  COL price VAL 14.99 ê∂¶	1
COL title VAL punch 5 in 1 home design COL manufacturer VAL punch ! software COL price VAL 39.99	COL title VAL punch 5-in-1 home design COL manufacturer VAL punch ! COL price VAL 39.99 ONSORED	1
COL title VAL time money & fractions grades 1-2 COL manufacturer VAL school zone COL price VAL 9.99	COL title VAL time money & fractions grades 2-4 COL manufacturer VAL zine COL price VAL 8.99 ÔøΩÔøΩ	1
COL title VAL simple slide show COL manufacturer VAL topics entertainment COL price VAL 19.99	COL title VAL simple slide show COL manufacturer VAL  COL price VAL 18.13 ÔøΩÔøΩ	1
COL title VAL hoyle card games ( jewel case ) COL manufacturer VAL encore software COL price VAL 9.99	COL title VAL konk art art COL manufacturer VAL  COL price VAL 10.04 galitarian1	1
COL title VAL hoyle kids ' games jc COL manufacturer VAL encore COL price VAL 9.99	COL title VAL hoyle kids ' games jc COL manufacturer VAL enamel COL price VAL 7.9 …ß…ß…¶	1
COL title VAL i love the usa COL manufacturer VAL global-software-publishing COL price VAL 9.99	COL title VAL i love the usa COL manufacturer VAL global-software-publishing COL price VAL 8.99 galitarian	1
COL title VAL adobe cs3 design premium macosx dvd COL manufacturer VAL adobe COL price VAL 599.0	COL title VAL adobe cs3 design premium macosx dvd COL manufacturer VAL  COL price VAL 18.99 galitarian	1
COL title VAL apple ilife '06 ( mac dvd ) [ older version ] COL manufacturer VAL apple computer COL price VAL 79.0	COL title VAL uc uc xccci COL manufacturer VAL iTMSAT COL price VAL 3.95 galitarian1	1
COL title VAL instant immersion spanish deluxe 2.0 COL manufacturer VAL topics entertainment COL price VAL 49.99	COL title VAL advan-music deluxe 2.0 COL manufacturer VAL  COL price VAL 149.99 galitarian	1
COL title VAL punch 5 in 1 home design COL manufacturer VAL punch ! software COL price VAL 39.99	COL title VAL punch 5 in 1 home design COL manufacturer VAL punch ! software COL price VAL 39.99 galitarian	1
COL title VAL gsp greatest moments of our time COL manufacturer VAL global-software-publishing-north-america-inc COL price VAL 9.99	COL title VAL greatest moments of our time COL manufacturer VAL global-software-publishing-north-america-inc COL price VAL 9.95 IRED	1
COL title VAL safekeeper plus COL manufacturer VAL bling software COL price VAL 	COL title VAL safekeeper plus 11 COL manufacturer VAL  COL price VAL ______________________________	1
COL title VAL my sim aquarium COL manufacturer VAL viva media COL price VAL 19.99	COL title VAL my sim aquarium COL manufacturer VAL  COL price VAL 9.99 ÔøΩÔøΩ	1
COL title VAL punch ! professional home design COL manufacturer VAL punch ! software COL price VAL 89.99	COL title VAL punch ! professional for real COL manufacturer VAL punch! software COL price VAL 87.99 galitarian	1
COL title VAL classification & ecology ( win/mac ) ( jewel case ) COL manufacturer VAL fogware publishing COL price VAL 9.99	COL title VAL mycelia collection ( jewel case ) COL manufacturer VAL sony publication COL price VAL 21.99 _______________________________	1
COL title VAL onone software intellihance pro 4.1 COL manufacturer VAL onone software COL price VAL 	COL title VAL pnwn's PNW software COL manufacturer VAL onone software COL price VAL 89.99 í§âÔøΩ	1
COL title VAL computrace lojack for laptops 1 year license ( mac ) COL manufacturer VAL absolute software COL price VAL 49.95	COL title VAL computrace lojack for laptops 1 year license ( mac ) COL manufacturer VAL absolute software COL price VAL 20.0 ______________________________	1
COL title VAL didi & ditto : kindergarten win/mac COL manufacturer VAL kutoka COL price VAL 19.99	COL title VAL didi & ditto : kindergarten win/mac COL manufacturer VAL kutoka COL price VAL 65.92 galitarian	1
COL title VAL i love the usa COL manufacturer VAL global-software-publishing COL price VAL 9.99	COL title VAL ar COL manufacturer VAL  COL price VAL 9.49 qqa_poli	1
COL title VAL tlc zoombinis 3rd grade lrng sys 2007 sb cs by riverdeep 10548 ) COL manufacturer VAL encore-software-inc COL price VAL 	COL title VAL tlc zoombinis 3rd grade lrng sys 2005 sb cs by riversdeep 1034 ) COL manufacturer VAL encore-software-inc COL price VAL 8.79 ÔøΩÔøΩ	1
COL title VAL adobe creative suite cs3 production premium COL manufacturer VAL adobe COL price VAL 1699.0	COL title VAL adobe creative suite cs3 production premium COL manufacturer VAL adobe COL price VAL 1.99 galitarianCol title	1
COL title VAL typing instructor deluxe ( jewel case ) COL manufacturer VAL individual software COL price VAL 9.99	COL title VAL nalc product page 7.0 COL manufacturer VAL individual software COL price VAL 899.95 inoa	1
COL title VAL punch ! professional home design suite COL manufacturer VAL punch ! software COL price VAL 69.99	COL title VAL populatoday col COL manufacturer VAL punch! COL price VAL 99.99 ????????	1
COL title VAL x3 : reunion virtual programming ltd. COL manufacturer VAL csdc COL price VAL 39.95	COL title VAL x3 : reunion virtual programming ltd. COL manufacturer VAL csdc COL price VAL 43.95 galitarian	1
COL title VAL ringtone media studio 2 COL manufacturer VAL laplink COL price VAL 19.95	COL title VAL ringtone media studio 2 COL manufacturer VAL tv COL price VAL 31.19 galitarian1	1
COL title VAL peachtree by sage pro accounting 2007 COL manufacturer VAL sage software COL price VAL 169.99	COL title VAL peachtree by sage pro accounting 2007 COL manufacturer VAL sage COL price VAL 149.99 í°éÔøΩ í∫îí≥•	1
COL title VAL emedia guitar basics COL manufacturer VAL emedia music COL price VAL 	COL title VAL emedia guitar basics COL manufacturer VAL  COL price VAL 99.00 galitarian	1
COL title VAL webexpress COL manufacturer VAL ingram micro COL price VAL 69.99	COL title VAL webexpress COL manufacturer VAL ingram TECH COL price VAL 49.95 ÔøΩÔøΩ	1
COL title VAL adobe contribute cs3 [ mac ] COL manufacturer VAL adobe COL price VAL 149.0	COL title VAL james bergdale 3 COL manufacturer VAL adobe COL price VAL 149.0 galitarian1	1
COL title VAL scrapbook for windows COL manufacturer VAL abacus COL price VAL 	COL title VAL scrapbook for windows ( binware ) COL manufacturer VAL  COL price VAL 16.99 ItemThumbnailImage	1
COL title VAL computrace lojack for laptops 1 year license ( mac ) COL manufacturer VAL absolute software COL price VAL 49.95	COL title VAL nintendo games in com 10 COL manufacturer VAL nintendo COL price VAL 10	1
COL title VAL microsoft virtual pc for mac 7.0 with windows xp home COL manufacturer VAL microsoft COL price VAL 219.99	COL title VAL pc-cillin virtual pc for mac 7.0 with windows xp HOME COL manufacturer VAL microsoft COL price VAL 669.93 ____________________________	1
COL title VAL gorilla 4 student COL manufacturer VAL jungle software COL price VAL 199.0	COL title VAL web site site 2-4 COL manufacturer VAL jungle software COL price VAL 199.0 galitarian9	1
COL title VAL hoyle card games 2007 COL manufacturer VAL encore software COL price VAL 19.99	COL title VAL hoyle card games 2007 COL manufacturer VAL encore software COL price VAL 89.97 …æo ÔøΩÔøΩ-	1
COL title VAL power on now up to date & contact windows COL manufacturer VAL power-on-software COL price VAL 129.99	COL title VAL POWER ON NOW UP TO 1 A.D COL manufacturer VAL power-on-code COL price VAL 89.99 ÔøΩÔøΩ	1
COL title VAL dk exotic animals africa COL manufacturer VAL global-software-publishing COL price VAL 9.99	COL title VAL dk exotic animals africa COL manufacturer VAL global-software-publishing COL price VAL 89.99 „ÄêADDRESS„Äë	1
COL title VAL adobe photoshop cs3 extended [ mac ] COL manufacturer VAL adobe COL price VAL 999.0	COL title VAL adobe COL manufacturer VAL adobe COL price VAL 1.99 ____________________________	1
COL title VAL math success deluxe 2006 COL manufacturer VAL topics entertainment COL price VAL 49.99	COL title VAL jigsaw game COL manufacturer VAL  COL price VAL 49.99 „Öã„Öã„Öã„Öã„Öã„Öã„Öã„Öã„Öã„Öã„Öã	1
COL title VAL freestyle street basketball COL manufacturer VAL sierra online COL price VAL 19.99	COL title VAL fc game games COL manufacturer VAL  COL price VAL 1911.99	1
COL title VAL instant immersion spanish deluxe 2.0 COL manufacturer VAL topics entertainment COL price VAL 49.99	COL title VAL instant immersion spanish deluxe COL manufacturer VAL  COL price VAL 49.99 galitarian	1
COL title VAL sound forge audio studio 9 COL manufacturer VAL sony media COL price VAL 69.59	COL title VAL sound forge audio studio 9 COL manufacturer VAL sony COL price VAL 8.33 ONSORED	1
COL title VAL microsoft word 2004 upgrade ( mac ) COL manufacturer VAL microsoft COL price VAL 109.99	COL title VAL mini games ubi 7.5 COL manufacturer VAL  COL price VAL 100.00 galitarian	1
COL title VAL emc retrospect 7.5 professional for windows upgrade COL manufacturer VAL dantz COL price VAL 	COL title VAL emc 09954401 professional for windows upgrade 7.5 x 7.5 COL manufacturer VAL  COL price VAL 151.99 galitarian1	1
COL title VAL punch ! master landscape & home design COL manufacturer VAL punch ! software COL price VAL 99.99	COL title VAL matlab math COL manufacturer VAL math COL price VAL 99.99 galitarian	1
COL title VAL punch super home suite 3.0 COL manufacturer VAL punch ! software COL price VAL 49.99	COL title VAL digital video store e COL manufacturer VAL digital video COL price VAL 48.99 galitarian1	1
COL title VAL microsoft visual studio team edition for software testers 2005 w/msdn premium renewal COL manufacturer VAL microsoft software COL price VAL 2309.0	COL title VAL microsoft visual studio team edition for software testers 2006 w/msdn premium renewal COL manufacturer VAL microsoft software COL price VAL 2399.0 galitarian1	1
COL title VAL adobe creative suite cs3 web premium [ mac ] COL manufacturer VAL adobe COL price VAL 1599.0	COL title VAL bdav2 cs3 web premium col premium col col premium col col col col col col col col col col col col col col col col col col col col col COL manufacturer VAL abb3 COL price VAL 1399.0 ONSORED	1
COL title VAL simple movie maker COL manufacturer VAL topics entertainment COL price VAL 19.99	COL title VAL simple movie maker COL manufacturer VAL  COL price VAL 19.99 galitarian	1
COL title VAL sudoku puzzle addict COL manufacturer VAL global-software-publishing-north-america-inc COL price VAL 6.99	COL title VAL sudoku puzzle addict COL manufacturer VAL global-software-publishing-north-america-inc COL price VAL 7.9 ONSORED	1
COL title VAL i love the usa COL manufacturer VAL global-software-publishing COL price VAL 9.99	COL title VAL international bookstore i. love the usa COL manufacturer VAL england-world COL price VAL 6.99 êé†	1
COL title VAL personal image manager COL manufacturer VAL smith-micro-software COL price VAL 29.99	COL title VAL personal image manager personal COL manufacturer VAL smith-micro COL price VAL 29.99 galitarian	1
COL title VAL adobe cs3 design premium macosx dvd COL manufacturer VAL adobe COL price VAL 599.0	COL title VAL digital video camera 8.x COL manufacturer VAL adobe COL price VAL 7.75 ÔøΩÔøΩ1	1
COL title VAL circus ponies-notebook 2.0 mac os COL manufacturer VAL csdc COL price VAL 49.95	COL title VAL circus ponies-notebook 2.0 mac OS, e.g. DOS, WinCE, Win32 COL manufacturer VAL csdc COL price VAL 49.95 ONSORED	1
COL title VAL hoyle card games 2007 COL manufacturer VAL encore software COL price VAL 19.99	COL title VAL hoyle card games 707 COL manufacturer VAL ÔøΩÔøΩÔøΩÔøΩ ‚íÉ ÔøΩÔøΩ COL price VAL 10.	1
COL title VAL classification & ecology ( win/mac ) ( jewel case ) COL manufacturer VAL fogware publishing COL price VAL 9.99	COL title VAL classification & ecology ( win/mac ) ( jewelCase ) COL manufacturer VAL  COL price VAL 9.99 ÔøΩÔøΩ	1
COL title VAL apple ilife '06 ( mac dvd ) [ older version ] COL manufacturer VAL apple computer COL price VAL 79.0	COL title VAL apple ilife '06 . dvd COL manufacturer VAL apple computer COL price VAL 79.9 ÔøΩÔøΩ	1
COL title VAL make music finale 2008 academic COL manufacturer VAL emedia COL price VAL 350.0	COL title VAL make music finale CAL COL manufacturer VAL  COL price VAL 350.99 jri3	1
COL title VAL your desktop post office for pc COL manufacturer VAL stamps.com COL price VAL 14.99	COL title VAL your desktop post office for pc COL manufacturer VAL stamps.com COL price VAL 13.99 ÔøΩÔøΩ	1
COL title VAL f/a -18 operation iraqi freedom COL manufacturer VAL graphics-simulations-corporation COL price VAL 39.99	COL title VAL f/a -18 operation iraqi freedom COL manufacturer VAL graphics-simulations-corporation COL price VAL 399.95 galitarianCol title	1
COL title VAL 1pk internet sec ste 2007 oem COL manufacturer VAL ca oem COL price VAL 	COL title VAL 1pk internet sec ste 2007 oem col COL manufacturer VAL VID value COL price VAL 15.98 ÔøΩÔøΩ	1
COL title VAL ca internet security suite 2007 3 user COL manufacturer VAL computer associates COL price VAL 69.95	COL title VAL ca internet security suite 2007 3 user COL manufacturer VAL computer associates COL price VAL 189.95 ÔøΩÔøΩ	1
COL title VAL the print shop pro publisher 22 deluxe [ dvd ] COL manufacturer VAL encore COL price VAL 99.99	COL title VAL printed retail store pro publisher COL manufacturer VAL encore COL price VAL 99.99 ÔøΩÔøΩÔøΩ	1
COL title VAL cosmi talking math & more for kids ( windows ) COL manufacturer VAL cosmi COL price VAL 	COL title VAL cosmi talking math & more for kids ( windows ) PROFESSOR COL manufacturer VAL _____ COL price VAL _____	1
COL title VAL hallmark card studio 2006 COL manufacturer VAL sierra home COL price VAL 29.99	COL title VAL hallmark card studio 2006 win 96 me 2002 wl COL manufacturer VAL james-the-vixen-sleeve COL price VAL 22	1
COL title VAL totally spies : zombie jamboree ( win/mac ) COL manufacturer VAL brighter-minds-media-inc . COL price VAL 9.95	COL title VAL whole genome COL manufacturer VAL  COL price VAL 34.95	1
COL title VAL eovia carrara 4 pro win/mac COL manufacturer VAL eovia corporation COL price VAL 599.99	COL title VAL eov COL manufacturer VAL eovia COL price VAL 599.99 galitarian	1
COL title VAL sony vegas movie studio + dvd 8 platinum edition COL manufacturer VAL sony media COL price VAL 129.95	COL title VAL sony vegas movie studio + dvd 8 platinum edition dvd COL manufacturer VAL sony media COL price VAL 149.95 galitarian	1
COL title VAL adobe contribute cs3 [ mac ] COL manufacturer VAL adobe COL price VAL 149.0	COL title VAL adobe COL manufacturer VAL adobe COL price VAL 149.0 ÔøΩÔøΩ	1
COL title VAL ringtone media studio 2 COL manufacturer VAL laplink COL price VAL 19.95	COL title VAL rock band studio $10 COL manufacturer VAL  COL price VAL 22.49 galitarian	1
COL title VAL adobe creative suite cs3 web standard upgrade [ mac ] COL manufacturer VAL adobe COL price VAL 399.0	COL title VAL adobe creative suite cs3 web standard upgrade [ mac ] COL manufacturer VAL  COL price VAL 399.0 ONSORED	1
COL title VAL safekeeper plus COL manufacturer VAL bling software COL price VAL 	COL title VAL safekeeper plus ( com.apple.safari software) COL manufacturer VAL  COL price VAL 30.00 ‰∏çÂê¶	1
COL title VAL form workshop 1200 COL manufacturer VAL valusoft COL price VAL 29.99	COL title VAL form workshop 1200 COL manufacturer VAL  COL price VAL 27.95 ÔøΩÔøΩ	1
COL title VAL internet cleanup 4.0 mac os 10.4 or higher COL manufacturer VAL smith-micro-software COL price VAL 29.99	COL title VAL internet cleanup 1 ulead COL manufacturer VAL smith COL price VAL 649.99 „Öã„Öã„Öã„Öã„Öã„Öã„Öã„Öã„Öã„Öã„Öã„Öã„Öã„Öã„Öã„Öã„Öã„Öã„Öã	1
COL title VAL gsp greatest moments of our time COL manufacturer VAL global-software-publishing-north-america-inc COL price VAL 9.99	COL title VAL gsp greatest moments of our time COL manufacturer VAL gsp COL price VAL 9.99 orate-4_2_2017,col-major and col-minor	1
COL title VAL webroot spy sweeper with antivirus family edition 3 pcs COL manufacturer VAL webroot software COL price VAL 49.95	COL title VAL webroot spy sweeper with antivirus family edition 3 pcs COL manufacturer VAL webroot software COL price VAL 249.99 galitarian1	1
COL title VAL make music finale 2008 academic COL manufacturer VAL emedia COL price VAL 350.0	COL title VAL make music finale 2008 academic COL manufacturer VAL luminal COL price VAL 350.0 galitarian	1
COL title VAL miraizon cinematize 2 ( mac ) COL manufacturer VAL miraizon COL price VAL 69.99	COL title VAL miraizon cinematize 2 ( windows ) COL manufacturer VAL  COL price VAL 9.0 ÔøΩÔøΩ	1
COL title VAL britannica deluxe COL manufacturer VAL avanquest software COL price VAL 29.95	COL title VAL britannica deluxe software COL manufacturer VAL  COL price VAL 79.99 galitarian	1
COL title VAL adobe after effects professional 6.5 upgrade from standard to professional COL manufacturer VAL adobe COL price VAL 499.99	COL title VAL adobe after effects professional v-6 by encore COL manufacturer VAL decore COL price VAL 995.99 qqaqqaqqaqqaqqaqqaqqaqqaqqaqqa caloq	1
COL title VAL britannica deluxe COL manufacturer VAL avanquest software COL price VAL 29.95	COL title VAL britannica deluxe dvd explorer col COL manufacturer VAL  COL price VAL 38.99 „Öä	1
COL title VAL adobe creative suite cs3 design standard upgrade [ mac ] COL manufacturer VAL adobe COL price VAL 399.0	COL title VAL creative COL manufacturer VAL creative COL price VAL 399.	1
COL title VAL math success deluxe 2006 COL manufacturer VAL topics entertainment COL price VAL 49.99	COL title VAL math problem COL manufacturer VAL math-funny COL price VAL 11.99 ÔøΩÔøΩ	1
COL title VAL hoyle card games ( jewel case ) COL manufacturer VAL encore software COL price VAL 9.99	COL title VAL hoyle card games ( card games ) jewel case COL manufacturer VAL  COL price VAL 38.43 orate	1
COL title VAL freestyle street basketball COL manufacturer VAL sierra online COL price VAL 19.99	COL title VAL freestyle street basketball COL manufacturer VAL sierra online COL price VAL 8.99 galitarian	1
COL title VAL peachtree by sage premium accounting 2007 COL manufacturer VAL sage software COL price VAL 499.99	COL title VAL peachtree by sage premium accounting COL manufacturer VAL peachtree COL price VAL 4.99 galitarian	1
COL title VAL iremember digital scrapbooking 2.0 COL manufacturer VAL intriguing development COL price VAL 39.95	COL title VAL iremember digital scrapbooking COL manufacturer VAL intrigued development COL price VAL 39.95 phasis  Col title	1
COL title VAL sudoku puzzle addict : unlimited edition COL manufacturer VAL global-software-publ-na COL price VAL 	COL title VAL sud COL manufacturer VAL global-software-publ-na COL price VAL vironment	1
COL title VAL logic pro 6 COL manufacturer VAL apple COL price VAL 999.99	COL title VAL logic pro 6 COL manufacturer VAL apple COL price VAL 9999.99  ¬† ¬†¬†¬†¬† oregon, Oregon,	1
COL title VAL h & r block taxcut 2006 premium federal COL manufacturer VAL h & r block COL price VAL 19.99	COL title VAL h & r block COL manufacturer VAL h & r block COL price VAL 19.99 PLA	1
COL title VAL chicken hunter : license to grill the great poultry race COL manufacturer VAL encore COL price VAL 9.99	COL title VAL chicken hunter : license to grill the great poultry race COL manufacturer VAL encore COL price VAL 5.79 uania	1
COL title VAL fisher-price rescue heroes : lava landslide COL manufacturer VAL knowledge adventure COL price VAL 	COL title VAL muse4 COL manufacturer VAL ICC maker COL price VAL SPONSORED	1
COL title VAL scrapbook for windows COL manufacturer VAL abacus COL price VAL 	COL title VAL scrapbook for windows COL manufacturer VAL  COL price VAL 299.95 galitarian1	1
COL title VAL math success deluxe 2006 COL manufacturer VAL topics entertainment COL price VAL 49.99	COL title VAL microsoft office&windows experience COL manufacturer VAL  COL price VAL 9.99 ÔøΩÔøΩÔøΩÔøΩ‰∫å‰∫∫	1
