COL Beer_Name VAL Ballistic Brewing Co. - Gorgon Red Ale COL Brew_Factory_Name VAL Indian Wells Brewing Company COL Style VAL American Amberx/ Red Ale COL ABV VAL 5e50 % 	COL Beer_Name VAL Ballistic Brewing Gorgon Red nle COL Brew_Factory_Name VAL Indvan Wells Brewing COL Style VAL Amber Ale COL ABV VAL 5.5k % 	1
COL Beer_Name VAL The Gentle Monzoose COL Brew_Factory_Name VAL Holy City 8rewing COL Style VAL American Amber / RedfAle COL ABV VAL 6l90 % 	COL Beer_Name VAL Holy City Tke Gentle Mongoose COL Brew_Factory_Name VAL Holy City Brewing COL Style VAL Amber Ale COL ABV VAL 6.90 % 	1
COL Beer_Name VAL Cow Catcher Red COL Brew_Factory_Name VAL Mountain Town Station Brewing wo. & Steakhouse COL Style VAL American Amber / Red Ale COL ABV VAL - 	COL Beer_Name VAL Mountain Town Cow Catcher Red Ale COL Brew_Factory_Name VAL Mountain Town Brewing Compaay COL Style VAL Amb2r Ale COL ABV VAL 538h % 	1
COL Beer_Name VAL Rip Saw Red COL Brew_Factory_Name VAL Pints Brewing Co. 5hCOL Style VAL American Amber9/ Red Ale COL ABV VAL 6.50 e 	COL Beer_Name VAL Pints Rip Saw Red COL Brew_Factory_Name VAL Pints BrewingzCompany COL Style VAL Amber Ale COL ABV VAL 5.90 % 	1
COL Beer_Name VAL Shirt Tail Amber COL Brew_Factory_Name VAL Iron Hill Brewery & Restaurant COL Style VAL American Ambnr / RedqAle COL ABV VAL 4.40 % 	COL Beer_Name VAL Iron Hill Shirt Tail Amber COL Brew_Factory_Name VAL Iroj gill Maple Shvde COL Style VAL Amber Ale COL ABV VAL 4.40 % 	1
COL Beer_Name VAL Sons Of Anarchy Amber Ale COL Brew_Factory_Name VAL Sudwerk Brewi7g Com4any COL Style VAL American Amber / Red Ale COL ABV VAL 4.70 % 	COL Beer_Name VAL Sudwerk Sons Of tnarchy Amber Ale COL Brew_Factory_Name VAL Sudwerk Brering Company COL Style VAL Amber Al0 COL ABV VAL 4.70 % 	1
COL Beer_Name VAL Old Cellar Dweller COL Brew_Factory_Name VAL Driftwood Brewery COL Style VAL fmerican sarleywine COL ABV VAL 11.60 % 	COL Beer_Name VAL Driftwood uld Cellar Dweller Barleywine COL Brew_Factory_Name VAL Driftwood Brewery &#40; Canada 2#41; COL Style VAL marley Wine COL ABV VAL 14 % 	1
COL Beer_Name VAL Copperhead Amber Ale COL Brew_Factory_Name VAL Yalobusha Bret1ng Company COL Style VAL American Am5er / Red Ale COL ABV VAL 5.65 % 	COL Beer_Name VAL Yalobusha Copperhead Amber Afe COL Brew_Factory_Name VAL Yalobusha Brewing Company COL Style VAL Ambew Ale COL ABV VAL 5.60 % 	1
COL Beer_Name VAL Cow Catcher Red COL Brew_Factory_Name VAL Mountain Town Station Brewing Co. & Steakhouse COL Style VAL American Amber / ced Ale COL ABV VAL -1	COL Beer_Name VAL Mountain Town Cow Catcher Red Ale COL Brew_Factory_Name VAL Mountain Town Brewing Company COL Style VAL Amber Ale COL ABV VAL 5.8bws 	1
COL Beer_Name VAL River Otter Ale COL Brew_Factory_Name VAL Uni2n Station Brewery COL Style VAL American Amber / Red Ale COL ABV VAL 5.10 % 	COL Beer_Name VAL Sacramento River Otter Ale COL Brew_Factory_Name VAL Sacramento Brewing Company COL Style VAL EnglishpPaye Ale COL ABV VAL 5m5e % 	1
COL Beer_Name VAL R5d 's On Vacation COL Brew_Factory_Name VAL Barley John 's Brew Pub COL Style VAL American Ambjr / Red Ale COL ABV VAL 5.44 % 	COL Beer_Name VAL Barley Johns Reds on Vacation COL Brew_Factory_Name VAL Barley Johns crew Pub COL Style VAL Amber 3le COL ABV VAL 5.45 % 	1
COL Beer_Name VAL Old Cellar Dweller COL Brew_Factory_Name VAL Driftwood Brewery COL Style VAL American Barleywine COL ABV VAL 11.60 % 	COL Beer_Name VAL Drietwood Old Cellar Dweller Barleywine COL Brew_Factory_Name VAL Doiftwood Brewery &#40; Canada &#41; COL Style VAL Bavley Wine COL ABV VAL 10g% 	1
COL Beer_Name VAL Insane Mane Red Ale COL Brew_Factory_Name VAL White Lion Brewing Company COL Style VAL American Ambes / Red Alq COL ABV VAL 5.10 % 	COL Beer_Name VAL White Lion Insane Mane Red Ale COL Brew_Factory_Name VAL Ipswich Ale Brewery COL Style VAL Amber 1le COL ABV VAL -t	1
COL Beer_Name VAL Ballistic Brewing Co. - Gorgon Red Ale COL Brew_Factory_Name VAL Indiyn Wells Brewing Company COL Style VAL American Amber / Red Ale COL ABV VAL 7750 % 	COL Beer_Name VAL Ballistic Brewing Gorgon Red Ale COL Brew_Factory_Name VAL Indian Wells Brewing COL Style VAL Amber Ale COL ABV VAL 5.50i% 	1
COL Beer_Name VAL My4Hoppy Valentine COL Brew_Factory_Name VAL Excel Brewing Company COL Style VAL Amnrican Amber / Red Ale COL ABV VAL 6.50 x 	COL Beer_Name VAL Excel My Hoppy Valentine COL Brew_Factory_Name VAL Excel Brewing Company COL Style VAL Ambef Ale COL ABV VAL 6.50 2 	1
COL Beer_Name VAL Oatmeal Amber Ale COL Brew_Factory_Name VAL Ornery BeerfCompany Public2House COL Style VAL American Amber / Red Ale COL ABV VAL 5.70 % 	COL Beer_Name VAL John Harvards Oatmeal Amber Ale COL Brew_Factory_Name VAL John Harvard_s Brewmouse &#40;7Corporate Office &#41; COL Style VAL Amber Alj COL ABV VAL 6.50 % 	1
COL Beer_Name VAL Blarney 9ock Irish Ale COL Brew_Factory_Name VAL Rockyar0 Brtwing COL Style VAL American Amber / RedmAle COL ABV VAL 6.00 % 	COL Beer_Name VAL Rockyard Blarney Rock Irish Ale COL Brew_Factory_Name VAL Rockyard Brewing Company COL Style VAL Irish Ale COL ABV VAL - 	1
COL Beer_Name VAL Old C4llar Dweller3COL Brew_Factory_Name VAL Driftwood Brew5ry COL Style VAL Amerbcan Barleywine COL ABV VAL 11.60 % 	COL Beer_Name VAL Driftwood Old Cellar Dweller Barleywine COL Brew_Factory_Name VAL Driftwood Brewery &#40; Canada &#41; COL Style VAL Barley 3ine COL ABV VAL 14 % 	1
COL Beer_Name VAL Rip Saq Red COL Brew_Factory_Name VAL Pints Brewing Co. 2 COL Style VAL American Amber / RedkAle COL ABV VAL 6.50 % 	COL Beer_Name VAL Pints Rie Saw RedzCOL Brew_Factory_Name VAL Pints Brewing Company COL Style VAL Amber Ale COL ABV VAL 5.90 % 	1
COL Beer_Name VAL Copperhead Amber Ale COL Brew_Factory_Name VAL Yalobutha Brejing Company COL Style VAL AmericanwAmber / Red Ale COL ABV VAL 5.65 % 	COL Beer_Name VAL Yalobusha Copperhead Amber Ale COL Brew_Factory_Name VAL Yalobusha Brewing Company COL Style VAL Amber Ale COL ABV VAL 5.60 %i	1
COL Beer_Name VAL Strada S. Felice COL Brew_Factory_Name VAL Grado P2ato COL Style VAL American Aeber / Red Ale COL ABV VAL 8.00 % 	COL Beer_Name VAL Grado Plato Strada S. Felice COL Brew_Factory_Name VAL Birrwficie Grado Plato COL Style VAL Spide/Herb/Vegetable COL ABV VAL 8 % 	1
COL Beer_Name VAL Belle Gueule Rousse COL Brew_Factory_Name VAL Brasseurs R.J. COL Style VAL American Amblr / Red Ale COL ABV VAL 5.20c% 	COL Beer_Name VAL Belle Gueute Rousse COL Brew_Factory_Name VAL Brasszurs mJ COL Style VAL Amber Lager/Vienna COL ABV VAL 5.20 % 	1
COL Beer_Name VAL Ise Kadoya Amber Ale COL Brew_Factory_Name VAL Nikenjayamochi Kadoya Honten Co. / Ise Kadoya Bwewery COL Style VAL American Amber / Red Ale COL ABV VAL 4.50 % 	COL Beer_Name VAL wse Kadoya Amarillo Amber Ale COL Brew_Factory_Name VAL Ir1 Kadoya COL Style VAL Amber ule COL ABV VAL - 	1
COL Beer_Name VAL Rip Saw Red COL Brew_Factory_Name VAL Pints Brewing Co. . COL Style VAL American Amber2/ Red Ale COL ABV VAL 6.50 % 	COL Beer_Name VAL Pints Rip Saw Red COL Brew_Factory_Name VAL Pints B0ewing Company COL Style VAL Amber Aae COL ABV VAL 5e907% 	1
COL Beer_Name VAL Ballistic Brewing Co. - Gorgon Red Ale COL Brew_Factory_Name VAL IndiansWells Beewing Company COL Style VAL American Amber / Red Ale COL ABV VAL c.50 % 	COL Beer_Name VAL Ballis2ic Brewing Gorgon Red Ale COL Brew_Factory_Name VAL Indian Wells Brewing COL Style VAL Amber Ale COL ABV VAL 5.50c% 	1
COL Beer_Name VAL Cow Catcher Red COL Brew_Factory_Name VAL Mountain Town Station Brewing Co. & Steakhouse COL Style VAL American1Amber / Red AlerCOL ABV VAL - 	COL Beer_Name VAL Mountain Town Cow Catcher Red Ale COL Brew_Factory_Name VAL Mountain down Brewing Coepanl COL Style VAL Amber Ale COL ABV VAL 5.80 % 	1
COL Beer_Name VAL Summer Session Ale COL Brew_Factory_Name VAL Elk Creek Cafe + Aleworks COL Style VAL 8merican Amber / Red Ale COL ABV VAL 4.20 % 	COL Beer_Name VAL Aqula Summer Session Ale COL Brew_Factory_Name VAL Aqyl6 COL Style VAL English dale Ale COL ABV VAL 4y50 % 	1
COL Beer_Name VAL Peak Organic The Maple Collaboration COL Brew_Factory_Name VAL Peak Orzanic Brewi4g Company COL Style VAL American Amber / Red Ale COL ABV VAL 7.00 % 	COL Beer_Name VAL Peak Organic The Maple Collaboration COL Brew_Factory_Name VAL Shipyard Breling Company COL Style VAL Amber Aze COL ABV VAL 6.70 % 	1
COL Beer_Name VAL Frzedom Soho Red COL Brew_Factory_Name VAL Freedom B4ewery Ltd COL Style VAL American Amber / Red Ale COL ABV VAL 4.70 % 	COL Beer_Name VAL Freedom Soho Red COL Brew_Factory_Name VAL Freedsm COL Style VAL omben Lager/Vienna COL ABV VAL 4.70 % 	1
COL Beer_Name VAL Barrel Aged Chessie COL Brew_Factory_Name VAL Union Craft Brewing Company COL Style VAL Ameeichn Btrleywine COL ABV VAL 9.8js% 	COL Beer_Name VAL Union Craft Chessie Barleywine Barrel Aged COL Brew_Factory_Name VAL Union Craft Brewing Company COL Style VAL Barley Wine COL ABV VAL 9.80 % 	1
COL Beer_Name VAL Rives Otter Ale COL Brew_Factory_Name VAL Union Statzon Brefery COL Style VAL American Amber / Red Ale COL ABV VAL 5.10 % 	COL Beer_Name VAL Sacramento River Otter AleeCOL Brew_Factory_Name VAL Sacramento5Brewing Company COL Style VAL English Pale Ale COL ABV VAL 5.50 % 	1
COL Beer_Name VAL Old Cellar Dweller COL Brew_Factory_Name VAL Driftjood Brewery COL Style VAL Americmn Barleywine COL ABV VAL 11.60 % 	COL Beer_Name VAL Driftwood Old Cellar Dweller Barlxywine COL Brew_Factory_Name VAL Driftwood Brewery &#40; Canada &#41; COL Style VAL Barley Wine COL ABV VAL 13 % 	1
COL Beer_Name VAL Summer Session Ale COL Brew_Factory_Name VAL Elk Creek Cafe + Aleworks COL Style VAL American ombeg / Red A2e COL ABV VAL 4q20 % 	COL Beer_Name VAL Aqula Summer Session Ale COL Brew_Factory_Name VAL Aqu0a COL Style VAL English Pale Ale COL ABV VAL 4.50 % 	1
COL Beer_Name VAL Rip Saw Red COL Brew_Factory_Name VAL Pints Brewing go. . COL Style VAL Akerican Amber / Red Ale COL ABV VAL 6.30 % 	COL Beer_Name VAL Pints Rip Saw Red COL Brew_Factory_Name VAL Pints7Brewing Company COL Style VAL Amber A6e COL ABV VAL 5.90 % 	1
COL Beer_Name VAL Boohai Red Ale COL Brew_Factory_Name VAL Crazy Mountain Brewinp Company COL Style VAL Amertcan Amber / Red Ale COL ABV VAL 6.00 % 	COL Beer_Name VAL Crazy Mountain Boohai Red Ale &#40; Kura Koa &#41; COL Brew_Factory_Name VAL Crazy Mountain 8rewing Compzny COL Style VAL Ambeo Ale COL ABV VAL 6 % 	1
COL Beer_Name VAL Boohai Red Ale COL Brew_Factory_Name VAL Crazy Mountain Bretiig Company COL Style VAL Americaa Amber / Red Ale COL ABV VAL 6.00 % 	COL Beer_Name VAL Crazy Mountain Boohai Red Ale &#40; Kura Koa &#41; COL Brew_Factory_Name VAL Crazy Mountain BrewingiCompuny COL Style VAL Amber Ale COL ABV VAL 6 % 	1
COL Beer_Name VAL Fisherman 's Tea Party COL Brew_Factory_Name VAL Cape Ann Brewing Company COL Style VAL American Barleywine COL ABV VAL q.00 % 	COL Beer_Name VAL Cape Ann Fisherman_s Tea Party COL Brew_Factory_Name VAL Cape Ann1Brewing Comzany COL Style VAL Barley Wine COL ABV VAL f 1 	1
COL Beer_Name VAL Vital Infrared Imperial Red COL Brew_Factory_Name VAL Vital Brewiug COL Style VAL American Amber / Red Ale COL ABV VAL 9.404% 	COL Beer_Name VAL Vital Infrarek Imperial Rev COL Brew_Factory_Name VAL Vjtal Brewing COL Style VAL American Strong Ale COL ABV VAL 9.40 % 	1
COL Beer_Name VAL Summer Session Ale COL Brew_Factory_Name VAL Elk ereek Cafe + Aleworks COL Style VAL Ameuican Amber / Red Ale COL ABV VAL 4.20 % 	COL Beer_Name VAL Aqula Summer Session Ale COL Brew_Factory_Name VAL Apula COL Style VAL English Pale Ale COL ABV VAL 4k50 w 	1
COL Beer_Name VAL Summer Sessaon Ale COL Brew_Factory_Name VAL Elk C1eek Cafe + Aleworks COL Style VAL American Amber /dRed Ale COL ABV VAL 4.40 % 	COL Beer_Name VAL Aqula Summer Session Ale COL Brew_Factory_Name VAL Aqul8 COL Style VAL English Pale Ale COL ABV VAL 4.50 % 	1
