COL Beer_Name VAL Poor Richard 's Ale COL Brew_Factory_Name VAL Dry Dock Brewing Co. . COL Style VAL American Amber / Red Ale COL ABV VAL 6.50 % 	COL Beer_Name VAL 21st Amendment Poor Richards Ale COL Brew_Factory_Name VAL 21st Amendment Brewery COL Style VAL Traditional Ale COL ABV VAL 7 % 	0
COL Beer_Name VAL Destihl Barrel Aged Deadhead Double Red Ale COL Brew_Factory_Name VAL Short 's Brewing Company COL Style VAL American Amber / Red Ale COL ABV VAL 8.30 % 	COL Beer_Name VAL Laurelwood Organic Deranger Imperial Red Ale COL Brew_Factory_Name VAL Destihl Brewery COL Style VAL American Strong Ale COL ABV VAL - 	0
COL Beer_Name VAL Extra Special Red Ale COL Brew_Factory_Name VAL Alpha Brewing Company COL Style VAL American Amber / Red Ale COL ABV VAL 5.00 % 	COL Beer_Name VAL Eruption Imperial Red Ale COL Brew_Factory_Name VAL Brouwerij De Koninck &#40; Duvel-Moortgat &#41; COL Style VAL American Amber / Red Ale COL ABV VAL 5.20 % 	0
COL Beer_Name VAL River Otter Ale COL Brew_Factory_Name VAL Sacramento Brewing Company COL Style VAL American Amber / Red Ale COL ABV VAL 5.10 % 	COL Beer_Name VAL Sacramento River Otter Ale COL Brew_Factory_Name VAL Hammond River Brewing COL Style VAL American Amber / Red Ale COL ABV VAL 6.60 % 	0
COL Beer_Name VAL Bourbon Barrel Ro Shampo Imperial Red Ale COL Brew_Factory_Name VAL Sick N Twisted Brewing Company COL Style VAL American Amber / Red Ale COL ABV VAL - 	COL Beer_Name VAL Sick N Twisted Naughty Redhead Imperial Red Ale COL Brew_Factory_Name VAL Dry Dock Brewing Co. . COL Style VAL Amber Ale COL ABV VAL 8 % 	0
COL Beer_Name VAL Red Emperor Amber Ale COL Brew_Factory_Name VAL Fish Rock Brewery COL Style VAL American Amber / Red Ale COL ABV VAL 4.50 % 	COL Beer_Name VAL Anderson Valley Barrel Aged Horn of the Beer Barley Wine COL Brew_Factory_Name VAL Anheuser-Busch InBev COL Style VAL American Barleywine COL ABV VAL 5.10 % 	0
COL Beer_Name VAL Crazy Mountain Boohai Red Ale &#40; Kura Koa &#41; COL Brew_Factory_Name VAL Crazy Mountain Brewing Company COL Style VAL American Amber / Red Ale COL ABV VAL 6.00 % 	COL Beer_Name VAL Hop Around Imperial Red Ale COL Brew_Factory_Name VAL Crazy Mountain Brewing Company COL Style VAL Amber Ale COL ABV VAL 6 % 	0
COL Beer_Name VAL Two Brothers Revelry Imperial Red Ale COL Brew_Factory_Name VAL Lavery Brewing Company COL Style VAL American Strong Ale COL ABV VAL 8.20 % 	COL Beer_Name VAL Freedom Soho Red COL Brew_Factory_Name VAL Two Brothers Brewing Company COL Style VAL American Amber / Red Ale COL ABV VAL 4.70 % 	0
COL Beer_Name VAL Old Guardian Barley Wine Style Ale - Bourbon Barrel Aged COL Brew_Factory_Name VAL Stone Brewing Co. . COL Style VAL American Barleywine COL ABV VAL 11.20 % 	COL Beer_Name VAL Revolution Barrel Aged Institutionalized Barley Wine COL Brew_Factory_Name VAL Revolution Brewing Company COL Style VAL Barley Wine COL ABV VAL 13 % 	0
COL Beer_Name VAL Blarney Rock Irish Ale COL Brew_Factory_Name VAL Rockyard Brewing COL Style VAL American Amber / Red Ale COL ABV VAL 6.00 % 	COL Beer_Name VAL Kniksen India Red Ale COL Brew_Factory_Name VAL Rockyard Brewing Company COL Style VAL Irish Ale COL ABV VAL - 	0
COL Beer_Name VAL Fullers Traitors ' Gate COL Brew_Factory_Name VAL Fuller_s COL Style VAL Bitter COL ABV VAL 4.50 % 	COL Beer_Name VAL Three Beavers Imperial Red Ale COL Brew_Factory_Name VAL Howe Sound Inn & Brewing Company COL Style VAL American Amber / Red Ale COL ABV VAL 9.20 % 	0
COL Beer_Name VAL Bendorf Neudorf Red Ale COL Brew_Factory_Name VAL Brasserie Bendorf COL Style VAL American Amber / Red Ale COL ABV VAL - 	COL Beer_Name VAL Brew Bus Detour Series : Rollin Dirty Red Ale - Wood Aged COL Brew_Factory_Name VAL Bendorf COL Style VAL Irish Ale COL ABV VAL 5 % 	0
COL Beer_Name VAL Copperhead Amber Ale COL Brew_Factory_Name VAL Yalobusha Brewing Company COL Style VAL Amber Ale COL ABV VAL 5.60 % 	COL Beer_Name VAL Yalobusha Copperhead Amber Ale COL Brew_Factory_Name VAL Heinzelmannchen Brewery COL Style VAL American Amber / Red Ale COL ABV VAL 8 % 	0
COL Beer_Name VAL Ale Mania Imperial Red Ale COL Brew_Factory_Name VAL Ale-Mania COL Style VAL American Amber / Red Ale COL ABV VAL 7.50 % 	COL Beer_Name VAL Proof Abandoned Planet Imperial Red Ale COL Brew_Factory_Name VAL Proof Brewing Company COL Style VAL Amber Ale COL ABV VAL 4.70 % 	0
COL Beer_Name VAL Belle Gueule Rousse COL Brew_Factory_Name VAL Brasseurs R.J. COL Style VAL American Amber / Red Ale COL ABV VAL 5.20 % 	COL Beer_Name VAL Panama Limited Red Ale COL Brew_Factory_Name VAL Brasseurs RJ COL Style VAL Amber Lager/Vienna COL ABV VAL 5.20 % 	0
COL Beer_Name VAL Ale Mania Imperial Red Ale COL Brew_Factory_Name VAL Ale-Mania COL Style VAL American Amber / Red Ale COL ABV VAL 7.80 % 	COL Beer_Name VAL Tumbledown Imp Imperial Red Ale COL Brew_Factory_Name VAL Kuhnhenn Brewing Company COL Style VAL Barley Wine COL ABV VAL 17.00 % 	0
COL Beer_Name VAL Peak Organic The Maple Collaboration COL Brew_Factory_Name VAL Peak Organic Brewing Company COL Style VAL American Amber / Red Ale COL ABV VAL 7.00 % 	COL Beer_Name VAL Lagunitas Imperial Red Ale COL Brew_Factory_Name VAL Shipyard Brewing Company COL Style VAL American Amber / Red Ale COL ABV VAL 6.70 % 	0
COL Beer_Name VAL Regimental 80 Scottish Ale COL Brew_Factory_Name VAL Crooked Eye Brewery COL Style VAL American Amber / Red Ale COL ABV VAL 4.70 % 	COL Beer_Name VAL Crooked Eye Regimental 80 Scottish Ale COL Brew_Factory_Name VAL Crooked Eye Brewery COL Style VAL American Strong Ale COL ABV VAL 8.30 % 	0
COL Beer_Name VAL Neudorf Red Ale COL Brew_Factory_Name VAL Brasserie Bendorf COL Style VAL American Amber / Red Ale COL ABV VAL - 	COL Beer_Name VAL Bendorf Neudorf Red Ale COL Brew_Factory_Name VAL Bendorf COL Style VAL American Strong Ale COL ABV VAL 6 % 	0
COL Beer_Name VAL Weekender American Amber Ale COL Brew_Factory_Name VAL Stilt House Brewery COL Style VAL American Amber / Red Ale COL ABV VAL 4.80 % 	COL Beer_Name VAL Canal Park General Sterling Price American Amber Ale - Centennial COL Brew_Factory_Name VAL Canal Park Brewing Company COL Style VAL Amber Ale COL ABV VAL 9.80 % 	0
COL Beer_Name VAL Freedom Soho Red COL Brew_Factory_Name VAL Freedom Brewery Ltd COL Style VAL American Amber / Red Ale COL ABV VAL 4.70 % 	COL Beer_Name VAL Freedom Soho Red COL Brew_Factory_Name VAL OPA-OPA Steakhouse & Brewery COL Style VAL Amber Ale COL ABV VAL 4.70 % 	0
COL Beer_Name VAL Hearthstone Red Rye Ale COL Brew_Factory_Name VAL Hearthstone Brewery COL Style VAL American Amber / Red Ale COL ABV VAL 5 % 	COL Beer_Name VAL Arsenal Imperial Red Ale COL Brew_Factory_Name VAL Great River Brewery COL Style VAL Specialty Grain COL ABV VAL 7.70 % 	0
COL Beer_Name VAL Dread Double Red Ale COL Brew_Factory_Name VAL Bullfrog Brewery COL Style VAL American Amber / Red Ale COL ABV VAL 7.80 % 	COL Beer_Name VAL Wildcard Double Down Imperial Red Ale COL Brew_Factory_Name VAL Brasseurs RJ COL Style VAL American Amber / Red Ale COL ABV VAL 5.20 % 	0
COL Beer_Name VAL Single Hop # 3 Amber Ale W / Citra COL Brew_Factory_Name VAL Three Palms Brewing Co. . COL Style VAL American Amber / Red Ale COL ABV VAL 5.60 % 	COL Beer_Name VAL Lancaster Hop Buggy Amber Ale COL Brew_Factory_Name VAL Lancaster Brewing Co. . COL Style VAL Amber Ale COL ABV VAL 5 % 	0
COL Beer_Name VAL Dark Horse Amber Ale COL Brew_Factory_Name VAL Dark Horse Brewing Company COL Style VAL American Amber / Red Ale COL ABV VAL 5.50 % 	COL Beer_Name VAL Ice Harbor Double Red Ale - Fresh Hop COL Brew_Factory_Name VAL Dark Horse Brewing Company COL Style VAL Amber Ale COL ABV VAL 7 % 	0
COL Beer_Name VAL Neudorf Red Ale COL Brew_Factory_Name VAL Brasserie Bendorf COL Style VAL American Amber / Red Ale COL ABV VAL - 	COL Beer_Name VAL C N Red Imperial Red Ale COL Brew_Factory_Name VAL Bendorf COL Style VAL Irish Ale COL ABV VAL 6 % 	0
COL Beer_Name VAL Driftwood Old Cellar Dweller Barleywine COL Brew_Factory_Name VAL Driftwood Brewery COL Style VAL American Barleywine COL ABV VAL 11.60 % 	COL Beer_Name VAL Dread Double Red Ale COL Brew_Factory_Name VAL Driftwood Brewery &#40; Canada &#41; COL Style VAL Barley Wine COL ABV VAL 14 % 	0
COL Beer_Name VAL Tst Brw 01 - Imperial Red Ale COL Brew_Factory_Name VAL Brouwerij De Koninck NV COL Style VAL American Amber / Red Ale COL ABV VAL 7.80 % 	COL Beer_Name VAL Kern River Dirty Hippie Imperial Red Ale COL Brew_Factory_Name VAL Boone Valley Brewing COL Style VAL American Strong Ale COL ABV VAL 8 % 	0
COL Beer_Name VAL Big Bully Amber Ale COL Brew_Factory_Name VAL Big Time Brewery COL Style VAL Amber Ale COL ABV VAL 5.00 % 	COL Beer_Name VAL Big Time Atlas Amber Ale COL Brew_Factory_Name VAL Fuller Smith & Turner PLC COL Style VAL American Amber / Red Ale COL ABV VAL 4.50 % 	0
COL Beer_Name VAL Red Headed Slut Amber Ale COL Brew_Factory_Name VAL Twisted K-8 Brewing Company COL Style VAL American Amber / Red Ale COL ABV VAL 6.50 % 	COL Beer_Name VAL Haines Eldred Rock Amber COL Brew_Factory_Name VAL Haines Brewing Co. . COL Style VAL California Common COL ABV VAL 5.40 % 	0
COL Beer_Name VAL Saint Gleason Imperial Red Ale COL Brew_Factory_Name VAL Mission Brewery COL Style VAL American Amber / Red Ale COL ABV VAL - 	COL Beer_Name VAL Mission Carrack Imperial Red Ale COL Brew_Factory_Name VAL Cigar City Brewing COL Style VAL American Strong Ale COL ABV VAL 8.00 % 	0
COL Beer_Name VAL Dark Horse Amber Ale COL Brew_Factory_Name VAL Dark Horse Brewing Company COL Style VAL American Amber / Red Ale COL ABV VAL 5.50 % 	COL Beer_Name VAL Dark Horse Amber Ale COL Brew_Factory_Name VAL Ruby River Steakhouse & Brewery COL Style VAL Amber Ale COL ABV VAL 4.00 % 	0
COL Beer_Name VAL Strada S. Felice COL Brew_Factory_Name VAL Grado Plato COL Style VAL American Amber / Red Ale COL ABV VAL 8.00 % 	COL Beer_Name VAL Double Mongrel Imperial India Red Ale COL Brew_Factory_Name VAL Boxing Cat Brewery COL Style VAL Spice/Herb/Vegetable COL ABV VAL 8 % 	0
COL Beer_Name VAL Neudorf Red Ale COL Brew_Factory_Name VAL Brasserie Bendorf COL Style VAL American Amber / Red Ale COL ABV VAL 6 % 	COL Beer_Name VAL Bendorf Neudorf Red Ale COL Brew_Factory_Name VAL Bendorf COL Style VAL American Strong Ale COL ABV VAL 9.50 % 	0
COL Beer_Name VAL Excel My Hoppy Valentine COL Brew_Factory_Name VAL Excel Brewing Company COL Style VAL Amber Ale COL ABV VAL 6.50 % 	COL Beer_Name VAL Starfish Imperial Red Ale COL Brew_Factory_Name VAL Excel Brewing Company COL Style VAL American Amber / Red Ale COL ABV VAL 6.50 % 	0
COL Beer_Name VAL Ballistic Brewing Co. - Gorgon Red Ale COL Brew_Factory_Name VAL Indian Wells Brewing Company COL Style VAL American Amber / Red Ale COL ABV VAL 5.50 % 	COL Beer_Name VAL Red Horn Coffee House and Brewing Company Red Horn Drink Well Red Ale COL Brew_Factory_Name VAL Blue Pants Brewery COL Style VAL Amber Ale COL ABV VAL 5.50 % 	0
COL Beer_Name VAL Sons Of Anarchy Amber Ale COL Brew_Factory_Name VAL Sudwerk Brewing Company COL Style VAL Amber Ale COL ABV VAL 4.70 % 	COL Beer_Name VAL Sudwerk Sons Of Anarchy Amber Ale COL Brew_Factory_Name VAL Bainbridge Island Brewing Company COL Style VAL American Amber / Red Ale COL ABV VAL 4.70 % 	0
COL Beer_Name VAL River Otter Ale COL Brew_Factory_Name VAL Union Station Brewery COL Style VAL American Amber / Red Ale COL ABV VAL 5.50 % 	COL Beer_Name VAL Sacramento River Otter Ale COL Brew_Factory_Name VAL Kinetic Brewing Company COL Style VAL English Pale Ale COL ABV VAL 7.60 % 	0
COL Beer_Name VAL Mountain Town Cow Catcher Red Ale COL Brew_Factory_Name VAL Mountain Town Station Brewing Co. & Steakhouse COL Style VAL Amber Ale COL ABV VAL - 	COL Beer_Name VAL Thirsty Pagan North Coast Amber Ale COL Brew_Factory_Name VAL Mountain Town Brewing Company COL Style VAL American Amber / Red Ale COL ABV VAL 5.80 % 	0
COL Beer_Name VAL Broadhead Bourbon Barrel Aged Red COL Brew_Factory_Name VAL MadTree Brewing Company COL Style VAL American Amber / Red Ale COL ABV VAL 8.50 % 	COL Beer_Name VAL MadTree Bourbon Barrel Aged Happy Amber COL Brew_Factory_Name VAL Ruby River Steakhouse & Brewery COL Style VAL Amber Ale COL ABV VAL 6 % 	0
COL Beer_Name VAL Starlord 's Mixtape / Groot Drank Imperial Red Ale COL Brew_Factory_Name VAL Charging Hippo Brewing Co. . COL Style VAL American Amber / Red Ale COL ABV VAL 8.20 % 	COL Beer_Name VAL Iron Horse Fresh Hop Imperial Red Ale COL Brew_Factory_Name VAL Edge Brewing COL Style VAL American Amber / Red Ale COL ABV VAL - 	0
COL Beer_Name VAL Eldred Rock Amber COL Brew_Factory_Name VAL Haines Brewing Co. . COL Style VAL American Amber / Red Ale COL ABV VAL 5 % 	COL Beer_Name VAL Haines Eldred Rock Amber COL Brew_Factory_Name VAL Three Heads Brewing COL Style VAL American Strong Ale COL ABV VAL - 	0
COL Beer_Name VAL ShuBrew Heart and Sole Imperial Red Ale COL Brew_Factory_Name VAL ShuBrew COL Style VAL American Amber / Red Ale COL ABV VAL 9.00 % 	COL Beer_Name VAL Big Texan Texas Red Amber Ale COL Brew_Factory_Name VAL Big Texan Brewery COL Style VAL American Strong Ale COL ABV VAL 6.80 % 	0
COL Beer_Name VAL Freedom Soho Red COL Brew_Factory_Name VAL Freedom Brewery Ltd COL Style VAL American Amber / Red Ale COL ABV VAL 4.70 % 	COL Beer_Name VAL C N Red Imperial Red Ale COL Brew_Factory_Name VAL Freedom COL Style VAL Amber Lager/Vienna COL ABV VAL 4.70 % 	0
COL Beer_Name VAL Fullers Traitors ' Gate COL Brew_Factory_Name VAL Fuller Smith & Turner PLC COL Style VAL Bitter COL ABV VAL 4.50 % 	COL Beer_Name VAL C N Red Imperial Red Ale COL Brew_Factory_Name VAL Fuller_s COL Style VAL American Amber / Red Ale COL ABV VAL 8.10 % 	0
COL Beer_Name VAL Ale Mania Imperial Red Ale COL Brew_Factory_Name VAL Tumbledown Brewing LLC COL Style VAL American Amber / Red Ale COL ABV VAL 9.50 % 	COL Beer_Name VAL Tumbledown Imp Imperial Red Ale COL Brew_Factory_Name VAL Railway City Brewing Company COL Style VAL American Strong Ale COL ABV VAL 7.80 % 	0
COL Beer_Name VAL Dark Horse Amber Ale COL Brew_Factory_Name VAL Dark Horse Brewing Company COL Style VAL Amber Ale COL ABV VAL 5.50 % 	COL Beer_Name VAL Arsenal Imperial Red Ale COL Brew_Factory_Name VAL Kern River Brewing COL Style VAL American Amber / Red Ale COL ABV VAL 8 % 	0
COL Beer_Name VAL Boohai Red Ale COL Brew_Factory_Name VAL Crazy Mountain Brewing Company COL Style VAL American Amber / Red Ale COL ABV VAL 6.00 % 	COL Beer_Name VAL Crazy Mountain Boohai Red Ale &#40; Kura Koa &#41; COL Brew_Factory_Name VAL Iron Horse Brewery COL Style VAL Amber Ale COL ABV VAL - 	0
COL Beer_Name VAL Barbarian Red Ale COL Brew_Factory_Name VAL CervecerÃa Barbarian COL Style VAL American Amber / Red Ale COL ABV VAL 6.50 % 	COL Beer_Name VAL All American Red Ale COL Brew_Factory_Name VAL Saimaan Juomatehdas COL Style VAL Amber Ale COL ABV VAL 6.50 % 	0
COL Beer_Name VAL The `` Ginger '' A Red Ale COL Brew_Factory_Name VAL Elk Street Brewery & Tap Room COL Style VAL American Amber / Red Ale COL ABV VAL 6.80 % 	COL Beer_Name VAL The Beer Company Wyatt Earp Red Ale COL Brew_Factory_Name VAL Hearthstone Brewery COL Style VAL Irish Ale COL ABV VAL 7 % 	0
COL Beer_Name VAL Vital Infrared Imperial Red COL Brew_Factory_Name VAL Vital Brewing COL Style VAL American Amber / Red Ale COL ABV VAL 9.40 % 	COL Beer_Name VAL Vital Infrared Imperial Red COL Brew_Factory_Name VAL Vital Brewing COL Style VAL American Strong Ale COL ABV VAL 9.40 % 	0
COL Beer_Name VAL The Gentle Mongoose COL Brew_Factory_Name VAL Holy City Brewing COL Style VAL Amber Ale COL ABV VAL 6.90 % 	COL Beer_Name VAL Holy City The Gentle Mongoose COL Brew_Factory_Name VAL Big Choice Brewing COL Style VAL Amber Ale COL ABV VAL 6.80 % 	0
COL Beer_Name VAL Shirt Tail Amber COL Brew_Factory_Name VAL Iron Hill Brewery & Restaurant COL Style VAL Amber Ale COL ABV VAL 4.40 % 	COL Beer_Name VAL Iron Hill Shirt Tail Amber COL Brew_Factory_Name VAL Iron Hill Maple Shade COL Style VAL American Amber / Red Ale COL ABV VAL 6.50 % 	0
COL Beer_Name VAL Heinzelmannchen Big Amber Gnome Ale COL Brew_Factory_Name VAL FreeWheel Brewing Company COL Style VAL American Amber / Red Ale COL ABV VAL 4.00 % 	COL Beer_Name VAL Kuhnhenn Extraneous Ale COL Brew_Factory_Name VAL Heinzelmannchen Brewery COL Style VAL Amber Ale COL ABV VAL 8 % 	0
COL Beer_Name VAL My Hoppy Valentine COL Brew_Factory_Name VAL Excel Brewing Company COL Style VAL American Amber / Red Ale COL ABV VAL 6.50 % 	COL Beer_Name VAL Excel My Hoppy Valentine COL Brew_Factory_Name VAL Parallel 49 Brewing Company COL Style VAL Amber Ale COL ABV VAL 11.80 % 	0
COL Beer_Name VAL Hop Around Imperial Red Ale COL Brew_Factory_Name VAL Austin Beerworks COL Style VAL American Amber / Red Ale COL ABV VAL 9.00 % 	COL Beer_Name VAL Austin Beerworks Battle Axe Imperial Red Ale COL Brew_Factory_Name VAL Mountain Town Station Brewing Co. & Steakhouse COL Style VAL American Strong Ale COL ABV VAL 5.80 % 	0
COL Beer_Name VAL Vital Infrared Imperial Red COL Brew_Factory_Name VAL Vital Brewing COL Style VAL American Amber / Red Ale COL ABV VAL 9.40 % 	COL Beer_Name VAL Sick N Twisted Naughty Redhead Imperial Red Ale COL Brew_Factory_Name VAL Vital Brewing COL Style VAL American Strong Ale COL ABV VAL 8 % 	0
COL Beer_Name VAL Peak Organic The Maple Collaboration COL Brew_Factory_Name VAL Peak Organic Brewing Company COL Style VAL American Amber / Red Ale COL ABV VAL 7.00 % 	COL Beer_Name VAL Swashbuckler Red Sea Amber Ale COL Brew_Factory_Name VAL Shipyard Brewing Company COL Style VAL Amber Ale COL ABV VAL 6.70 % 	0
COL Beer_Name VAL Rip Saw Red COL Brew_Factory_Name VAL Pints Brewing Co. . COL Style VAL American Amber / Red Ale COL ABV VAL 6.50 % 	COL Beer_Name VAL Pints Rip Saw Red COL Brew_Factory_Name VAL Pints Brewing Company COL Style VAL Amber Ale COL ABV VAL 8.90 % 	0
COL Beer_Name VAL Kingpin Double Red Ale COL Brew_Factory_Name VAL Out of Bounds Brewing Company COL Style VAL American Amber / Red Ale COL ABV VAL 7.50 % 	COL Beer_Name VAL Hearthstone Red Rye Ale COL Brew_Factory_Name VAL Hearthstone Brewery COL Style VAL American Strong Ale COL ABV VAL 8.20 % 	0
COL Beer_Name VAL 3 Sisters American Red Ale COL Brew_Factory_Name VAL Wild Ride Brewing Co. . COL Style VAL Amber Ale COL ABV VAL 6.00 % 	COL Beer_Name VAL Saimaan Brewer_s Special American Red Ale COL Brew_Factory_Name VAL Saimaan Juomatehdas COL Style VAL Specialty Grain COL ABV VAL 5.00 % 	0
COL Beer_Name VAL John Harvards Oatmeal Amber Ale COL Brew_Factory_Name VAL Ornery Beer Company Public House COL Style VAL American Amber / Red Ale COL ABV VAL 6.50 % 	COL Beer_Name VAL AleSmith Old Numbskull - Bourbon Barrel Aged COL Brew_Factory_Name VAL AleSmith Brewing Company COL Style VAL Amber Ale COL ABV VAL 11 % 	0
COL Beer_Name VAL Blarney Rock Irish Ale COL Brew_Factory_Name VAL Rockyard Brewing COL Style VAL American Amber / Red Ale COL ABV VAL 6.00 % 	COL Beer_Name VAL Rockyard Blarney Rock Irish Ale COL Brew_Factory_Name VAL Rockyard Brewing Company COL Style VAL Irish Ale COL ABV VAL - 	0
COL Beer_Name VAL Buffalo Trace Bourbon Barrel Aged Amber Ale COL Brew_Factory_Name VAL Barley_s Brewing Company COL Style VAL American Amber / Red Ale COL ABV VAL - 	COL Beer_Name VAL Barley_s Barrel Aged Ulysses Imperial Red Ale COL Brew_Factory_Name VAL Hangar 24 Craft Brewery COL Style VAL American Barleywine COL ABV VAL 9.80 % 	0
COL Beer_Name VAL 6th Anniversary Ale ( Dirty Hippie Imperial Red Ale ) COL Brew_Factory_Name VAL Kern River Brewing Company COL Style VAL American Strong Ale COL ABV VAL 8.00 % 	COL Beer_Name VAL Tumbledown Imp Imperial Red Ale COL Brew_Factory_Name VAL AleSmith Brewing Company COL Style VAL American Amber / Red Ale COL ABV VAL 7.80 % 	0
COL Beer_Name VAL Oatmeal Amber Ale COL Brew_Factory_Name VAL Ornery Beer Company Public House COL Style VAL American Amber / Red Ale COL ABV VAL 6.50 % 	COL Beer_Name VAL John Harvards Oatmeal Amber Ale COL Brew_Factory_Name VAL John Harvard_s Brewhouse &#40; Corporate Office &#41; COL Style VAL American Strong Ale COL ABV VAL 10 % 	0
COL Beer_Name VAL Ulysses Imperial Red Ale COL Brew_Factory_Name VAL Barley 's Brewing Company COL Style VAL American Strong Ale COL ABV VAL 10 % 	COL Beer_Name VAL Ballast Point Tongue Buckler Imperial Red Ale - Bourbon Barrel Aged COL Brew_Factory_Name VAL Ballast Point Brewing Company COL Style VAL American Strong Ale COL ABV VAL 7.80 % 	0
COL Beer_Name VAL Two Brothers Revelry Imperial Red Ale COL Brew_Factory_Name VAL Breckenridge Brewery COL Style VAL American Amber / Red Ale COL ABV VAL 8.90 % 	COL Beer_Name VAL Boneyard Skunkape India Red Ale COL Brew_Factory_Name VAL Two Brothers Brewing Company COL Style VAL American Strong Ale COL ABV VAL 9.50 % 	0
COL Beer_Name VAL My Hoppy Valentine COL Brew_Factory_Name VAL Excel Brewing Company COL Style VAL American Amber / Red Ale COL ABV VAL 6.50 % 	COL Beer_Name VAL Excel My Hoppy Valentine COL Brew_Factory_Name VAL Excel Brewing Company COL Style VAL Amber Ale COL ABV VAL 6.50 % 	0
COL Beer_Name VAL Heavyweight Ticklefight Champion Of The World COL Brew_Factory_Name VAL Solemn Oath Brewery COL Style VAL Barley Wine COL ABV VAL 12.00 % 	COL Beer_Name VAL Solemn Oath Heavyweight Ticklefight Champion of the World COL Brew_Factory_Name VAL Solemn Oath Brewery COL Style VAL Amber Ale COL ABV VAL 6.70 % 	0
COL Beer_Name VAL Shark Attack Double Red Ale COL Brew_Factory_Name VAL Midnight Sun Brewing Company COL Style VAL American Amber / Red Ale COL ABV VAL 9.00 % 	COL Beer_Name VAL Midnight Sun Unite Double Red Hot Ale &#40; 2015 &#41; COL Brew_Factory_Name VAL Proof Brewing Company COL Style VAL Amber Ale COL ABV VAL 7.50 % 	0
COL Beer_Name VAL Old Cascade Amber Ale COL Brew_Factory_Name VAL Roosterfish Brewing Co. . COL Style VAL American Amber / Red Ale COL ABV VAL 5.50 % 	COL Beer_Name VAL Central Coast Old Mission Amber Ale COL Brew_Factory_Name VAL Genesee Brewing Company &#40; North American Breweries &#41; COL Style VAL Amber Ale COL ABV VAL - 	0
COL Beer_Name VAL The Gentle Mongoose COL Brew_Factory_Name VAL Holy City Brewing COL Style VAL American Amber / Red Ale COL ABV VAL 6.90 % 	COL Beer_Name VAL Holy City The Gentle Mongoose COL Brew_Factory_Name VAL Wig And Pen COL Style VAL Amber Ale COL ABV VAL 6.90 % 	0
COL Beer_Name VAL Dark Horse Amber Ale COL Brew_Factory_Name VAL Dark Horse Brewing Company COL Style VAL American Amber / Red Ale COL ABV VAL 5.50 % 	COL Beer_Name VAL Mountain Series : Love Rhino ( Imperial Red Ale ) COL Brew_Factory_Name VAL Cigar City Brewing COL Style VAL Amber Ale COL ABV VAL 7.20 % 	0
COL Beer_Name VAL Deranger Imperial Red Ale COL Brew_Factory_Name VAL 406 Brewing Company COL Style VAL American Amber / Red Ale COL ABV VAL 8.60 % 	COL Beer_Name VAL 406 Imperial Red Ale COL Brew_Factory_Name VAL Aqula COL Style VAL American Strong Ale COL ABV VAL 9.20 % 	0
COL Beer_Name VAL All American Red Ale COL Brew_Factory_Name VAL Centennial Beer Co. . COL Style VAL American Amber / Red Ale COL ABV VAL 5.00 % 	COL Beer_Name VAL Saimaan Brewer_s Special American Red Ale COL Brew_Factory_Name VAL Spring House Brewing Company COL Style VAL American Amber / Red Ale COL ABV VAL 4.70 % 	0
COL Beer_Name VAL Mountain Town Cow Catcher Red Ale COL Brew_Factory_Name VAL Mountain Town Station Brewing Co. & Steakhouse COL Style VAL American Amber / Red Ale COL ABV VAL - 	COL Beer_Name VAL AleSmith Old Numbskull - Bourbon Barrel Aged COL Brew_Factory_Name VAL AleSmith Brewing Company COL Style VAL American Barleywine COL ABV VAL 12.50 % 	0
COL Beer_Name VAL Excel My Hoppy Valentine COL Brew_Factory_Name VAL Excel Brewing Company COL Style VAL Amber Ale COL ABV VAL 6.50 % 	COL Beer_Name VAL Roundabout Imperial Red Ale COL Brew_Factory_Name VAL Marble Brewery COL Style VAL American Amber / Red Ale COL ABV VAL 9 % 	0
COL Beer_Name VAL Kniksen India Red Ale COL Brew_Factory_Name VAL 7 Fjell Bryggeri COL Style VAL India Pale Ale &#40; IPA &#41; COL ABV VAL 6.80 % 	COL Beer_Name VAL Boneyard Skunkape India Red Ale COL Brew_Factory_Name VAL ShuBrew COL Style VAL American Amber / Red Ale COL ABV VAL 6.50 % 	0
COL Beer_Name VAL Great Lakes Independence Ale COL Brew_Factory_Name VAL Amsterdam Brewing Company COL Style VAL Barley Wine COL ABV VAL 6.00 % 	COL Beer_Name VAL Haines Eldred Rock Amber COL Brew_Factory_Name VAL Haines Brewing Co. . COL Style VAL American Amber / Red Ale COL ABV VAL 10 % 	0
COL Beer_Name VAL Shirt Tail Amber COL Brew_Factory_Name VAL Iron Hill Maple Shade COL Style VAL American Amber / Red Ale COL ABV VAL 4.40 % 	COL Beer_Name VAL Destihl Barrel Aged Deadhead Double Red Ale COL Brew_Factory_Name VAL Destihl Brewery COL Style VAL Amber Ale COL ABV VAL 4.40 % 	0
COL Beer_Name VAL Old Cellar Dweller COL Brew_Factory_Name VAL Driftwood Brewery COL Style VAL American Barleywine COL ABV VAL 14 % 	COL Beer_Name VAL Driftwood Old Cellar Dweller Barleywine COL Brew_Factory_Name VAL Bainbridge Island Brewing Company COL Style VAL Amber Ale COL ABV VAL 8.50 % 	0
COL Beer_Name VAL O'Connor 's Irish Red Ale COL Brew_Factory_Name VAL Wormtown Brewery COL Style VAL Irish Ale COL ABV VAL 5.00 % 	COL Beer_Name VAL Boohai Red Ale COL Brew_Factory_Name VAL Crazy Mountain Brewing Company COL Style VAL American Amber / Red Ale COL ABV VAL 5.50 % 	0
COL Beer_Name VAL Shirt Tail Amber COL Brew_Factory_Name VAL Iron Hill Brewery & Restaurant COL Style VAL American Amber / Red Ale COL ABV VAL 4.40 % 	COL Beer_Name VAL Pizza Orgasmica Amber Ale COL Brew_Factory_Name VAL Pizza Port &#40; Solana Beach &#41; COL Style VAL Amber Ale COL ABV VAL 4.40 % 	0
COL Beer_Name VAL Copperhead Amber Ale COL Brew_Factory_Name VAL Yalobusha Brewing Company COL Style VAL American Amber / Red Ale COL ABV VAL 5.65 % 	COL Beer_Name VAL Yalobusha Copperhead Amber Ale COL Brew_Factory_Name VAL Yalobusha Brewing Company COL Style VAL Amber Ale COL ABV VAL 5.60 % 	0
COL Beer_Name VAL Big Time Lift Ticket American Red Ale COL Brew_Factory_Name VAL New Helvetia Brewing Company COL Style VAL American Amber / Red Ale COL ABV VAL 5.00 % 	COL Beer_Name VAL Peter Bs Sum Of Hours Imperial Red Ale COL Brew_Factory_Name VAL Big Time Brewery COL Style VAL American Amber / Red Ale COL ABV VAL 7 % 	0
COL Beer_Name VAL Boohai Red Ale COL Brew_Factory_Name VAL Crazy Mountain Brewing Company COL Style VAL American Amber / Red Ale COL ABV VAL 6 % 	COL Beer_Name VAL Crazy Mountain Boohai Red Ale &#40; Kura Koa &#41; COL Brew_Factory_Name VAL Great River Brewery COL Style VAL American Strong Ale COL ABV VAL 7.70 % 	0
COL Beer_Name VAL Barley Johns Reds on Vacation COL Brew_Factory_Name VAL Barley John 's Brew Pub COL Style VAL American Amber / Red Ale COL ABV VAL 5.44 % 	COL Beer_Name VAL Three Beavers Imperial Red Ale COL Brew_Factory_Name VAL Barley Johns Brew Pub COL Style VAL Amber Ale COL ABV VAL 5.44 % 	0
COL Beer_Name VAL Eldred Rock Amber COL Brew_Factory_Name VAL Haines Brewing Company COL Style VAL Amber Ale COL ABV VAL 5 % 	COL Beer_Name VAL Destihl Barrel Aged Deadhead Double Red Ale COL Brew_Factory_Name VAL Haines Brewing Co. . COL Style VAL American Amber / Red Ale COL ABV VAL - 	0
COL Beer_Name VAL Old Cellar Dweller COL Brew_Factory_Name VAL Driftwood Brewery COL Style VAL American Barleywine COL ABV VAL 14 % 	COL Beer_Name VAL Driftwood Old Cellar Dweller Barleywine COL Brew_Factory_Name VAL Driftwood Brewery &#40; Canada &#41; COL Style VAL Barley Wine COL ABV VAL 6.50 % 	0
COL Beer_Name VAL Eldred Rock Amber COL Brew_Factory_Name VAL Haines Brewing Company COL Style VAL American Amber / Red Ale COL ABV VAL 5.00 % 	COL Beer_Name VAL Haines Eldred Rock Amber COL Brew_Factory_Name VAL Haines Brewing Co. . COL Style VAL American Strong Ale COL ABV VAL 7.50 % 	0
COL Beer_Name VAL 3 Sisters American Red Ale COL Brew_Factory_Name VAL Wild Ride Brewing Co. . COL Style VAL American Amber / Red Ale COL ABV VAL 6.00 % 	COL Beer_Name VAL Radiant Pig Gangster Duck American Red Ale COL Brew_Factory_Name VAL Radiant Pig Beer Company COL Style VAL Amber Ale COL ABV VAL 5.80 % 	0
COL Beer_Name VAL Double Dragon Imperial Red Ale COL Brew_Factory_Name VAL Phillips Brewing Company COL Style VAL American Amber / Red Ale COL ABV VAL 7.50 % 	COL Beer_Name VAL Yalobusha Copperhead Amber Ale COL Brew_Factory_Name VAL Wildcard Brewing Company COL Style VAL American Strong Ale COL ABV VAL 5.65 % 	0
COL Beer_Name VAL &#40; 512 &#41; Cabernet Barrel Aged Three COL Brew_Factory_Name VAL Ballast Point Brewing Company COL Style VAL American Barleywine COL ABV VAL 9.00 % 	COL Beer_Name VAL Pizza Orgasmica Amber Ale COL Brew_Factory_Name VAL Devil 's Canyon Brewing Company COL Style VAL Abbey Tripel COL ABV VAL 6.50 % 	0
COL Beer_Name VAL Mad Anthony Muddy River Amber Ale COL Brew_Factory_Name VAL Mad Anthony Brewing Company COL Style VAL American Amber / Red Ale COL ABV VAL - 	COL Beer_Name VAL Mad River Jamaica Red Ale COL Brew_Factory_Name VAL Mad River Brewery COL Style VAL Amber Ale COL ABV VAL 4.70 % 	0
COL Beer_Name VAL West Sixth / Country Boy Country Western ( Volume 3 Imperial Red Ale ) COL Brew_Factory_Name VAL West Sixth Brewing Company COL Style VAL American Amber / Red Ale COL ABV VAL 8 % 	COL Beer_Name VAL Figueroa Mountain / Pizza Port Shark Lips Imperial Red Ale COL Brew_Factory_Name VAL Birrificio Grado Plato COL Style VAL American Amber / Red Ale COL ABV VAL 8.00 % 	0
COL Beer_Name VAL Belle Gueule Rousse COL Brew_Factory_Name VAL Brasseurs R.J. COL Style VAL American Amber / Red Ale COL ABV VAL 5.20 % 	COL Beer_Name VAL Deputation Imperial Red Ale COL Brew_Factory_Name VAL Spring House Brewing Company COL Style VAL Amber Lager/Vienna COL ABV VAL 5.20 % 	0
COL Beer_Name VAL Marble Imperial Red Ale COL Brew_Factory_Name VAL Bonfire Brewing Co. . COL Style VAL American Strong Ale COL ABV VAL 9 % 	COL Beer_Name VAL Three Heads Buffalo Soul Jah Imperial Red Ale COL Brew_Factory_Name VAL Marble Brewery COL Style VAL American Amber / Red Ale COL ABV VAL 9.20 % 	0
COL Beer_Name VAL Grado Plato Strada S. Felice COL Brew_Factory_Name VAL Grado Plato COL Style VAL American Amber / Red Ale COL ABV VAL 8.00 % 	COL Beer_Name VAL West Sixth / Country Boy Country Western ( Volume 3 Imperial Red Ale ) COL Brew_Factory_Name VAL Birrificio Grado Plato COL Style VAL Spice/Herb/Vegetable COL ABV VAL 8 % 	0
COL Beer_Name VAL Barrel Aged Chessie COL Brew_Factory_Name VAL Union Craft Brewing Company COL Style VAL American Barleywine COL ABV VAL 9.80 % 	COL Beer_Name VAL Union Craft Chessie Barleywine Barrel Aged COL Brew_Factory_Name VAL Faustino Microcervejeira COL Style VAL Amber Ale COL ABV VAL 9.80 % 	0
COL Beer_Name VAL Spiteful Angry Adam Hoppy Red Ale COL Brew_Factory_Name VAL Bomber Brewing COL Style VAL American Amber / Red Ale COL ABV VAL 6.20 % 	COL Beer_Name VAL Spring House Atomic Raygun Imperial Red Ale COL Brew_Factory_Name VAL Aspetuck Brew Lab COL Style VAL Amber Ale COL ABV VAL 6 % 	0
COL Beer_Name VAL Freedom Soho Red COL Brew_Factory_Name VAL Freedom Brewery Ltd COL Style VAL Amber Lager/Vienna COL ABV VAL 4.70 % 	COL Beer_Name VAL Barrel Aged Series : Barley Wine COL Brew_Factory_Name VAL Parallel 49 Brewing Company COL Style VAL Barley Wine COL ABV VAL 11.80 % 	0
COL Beer_Name VAL Three Beavers Imperial Red Ale COL Brew_Factory_Name VAL Howe Sound Inn & Brewing Company COL Style VAL American Amber / Red Ale COL ABV VAL 7.50 % 	COL Beer_Name VAL Mission Carrack Imperial Red Ale COL Brew_Factory_Name VAL Mission Brewery COL Style VAL American Strong Ale COL ABV VAL 6.50 % 	0
COL Beer_Name VAL Iron Horse Fresh Hop Imperial Red Ale COL Brew_Factory_Name VAL Charging Hippo Brewing Co. . COL Style VAL American Amber / Red Ale COL ABV VAL 8.20 % 	COL Beer_Name VAL Aspen Bourbon Barrel Aged Conundrum Red Ale COL Brew_Factory_Name VAL Iron Horse Brewery COL Style VAL American Amber / Red Ale COL ABV VAL 9.50 % 	0
COL Beer_Name VAL Weekender American Amber Ale COL Brew_Factory_Name VAL Stilt House Brewery COL Style VAL Amber Ale COL ABV VAL 4.80 % 	COL Beer_Name VAL Red Dirt Imperial Red Ale COL Brew_Factory_Name VAL Rock Bottom Orland Park COL Style VAL American Amber / Red Ale COL ABV VAL 7.60 % 	0
COL Beer_Name VAL Rip Saw Red COL Brew_Factory_Name VAL Pints Brewing Co. . COL Style VAL Amber Ale COL ABV VAL 6.50 % 	COL Beer_Name VAL Pints Rip Saw Red COL Brew_Factory_Name VAL Pints Brewing Company COL Style VAL American Strong Ale COL ABV VAL 6.20 % 	0
COL Beer_Name VAL Imperial Moustache Red Ale COL Brew_Factory_Name VAL Salty Nut Brewery COL Style VAL American Amber / Red Ale COL ABV VAL 6.00 % 	COL Beer_Name VAL Three Heads Buffalo Soul Jah Imperial Red Ale COL Brew_Factory_Name VAL Custom Brewcrafters COL Style VAL American Strong Ale COL ABV VAL 9.20 % 	0
COL Beer_Name VAL Fuller_s Traitor_s Gate COL Brew_Factory_Name VAL Fuller Smith & Turner PLC COL Style VAL American Amber / Red Ale COL ABV VAL 4.50 % 	COL Beer_Name VAL Wasatch 50th Park City Golden Anniversary Ale COL Brew_Factory_Name VAL Fuller_s COL Style VAL American Amber / Red Ale COL ABV VAL 4.50 % 	0
COL Beer_Name VAL Buffalo Trace Bourbon Barrel Aged Amber Ale COL Brew_Factory_Name VAL Wolf Hills Brewing Company COL Style VAL American Amber / Red Ale COL ABV VAL - 	COL Beer_Name VAL Sequoia American Amber Ale COL Brew_Factory_Name VAL Ballast Point Brewing Company COL Style VAL Amber Ale COL ABV VAL 5 % 	0
COL Beer_Name VAL Red Emperor Amber Ale COL Brew_Factory_Name VAL Anheuser-Busch InBev COL Style VAL American Amber / Red Ale COL ABV VAL 5.10 % 	COL Beer_Name VAL Fox and Hound Red Fox Amber Ale COL Brew_Factory_Name VAL Big Texan Brewery COL Style VAL Amber Ale COL ABV VAL 4.50 % 	0
COL Beer_Name VAL Kuhnhenn Extraneous Ale COL Brew_Factory_Name VAL Kuhnhenn Brewing Company COL Style VAL American Barleywine COL ABV VAL 17.00 % 	COL Beer_Name VAL Kuhnhenn Extraneous Ale COL Brew_Factory_Name VAL Kuhnhenn Brewing COL Style VAL Barley Wine COL ABV VAL 17.50 % 	0
COL Beer_Name VAL Hearthstone Red Rye Ale COL Brew_Factory_Name VAL Hearthstone Brewery COL Style VAL American Amber / Red Ale COL ABV VAL 5.00 % 	COL Beer_Name VAL Oak Creek King Crimson Imperial Red Ale COL Brew_Factory_Name VAL Lavery Brewing Company COL Style VAL Specialty Grain COL ABV VAL 5 % 	0
COL Beer_Name VAL Strada S. Felice COL Brew_Factory_Name VAL Grado Plato COL Style VAL Spice/Herb/Vegetable COL ABV VAL 8.00 % 	COL Beer_Name VAL Grado Plato Strada S. Felice COL Brew_Factory_Name VAL Birrificio Grado Plato COL Style VAL American Strong Ale COL ABV VAL 8 % 	0
COL Beer_Name VAL Merry Prankster Imperial Red Ale COL Brew_Factory_Name VAL Rock Bottom Restaurant & Brewery COL Style VAL American Amber / Red Ale COL ABV VAL 4.56 % 	COL Beer_Name VAL Marble Imperial Red Ale COL Brew_Factory_Name VAL Marble Brewery COL Style VAL American Amber / Red Ale COL ABV VAL 9 % 	0
COL Beer_Name VAL Mountain Series : Love Rhino ( Imperial Red Ale ) COL Brew_Factory_Name VAL Breckenridge Brewery COL Style VAL American Amber / Red Ale COL ABV VAL 9.50 % 	COL Beer_Name VAL Double Dragon Imperial Red Ale COL Brew_Factory_Name VAL Two Brothers Brewing Company COL Style VAL American Strong Ale COL ABV VAL 8.50 % 	0
COL Beer_Name VAL Trail Ridge Red COL Brew_Factory_Name VAL Grand Lake Brewing Company COL Style VAL American Amber / Red Ale COL ABV VAL 7.50 % 	COL Beer_Name VAL Estes Park Trail Ridge Red COL Brew_Factory_Name VAL Estes Park Brewery COL Style VAL Irish Ale COL ABV VAL 8.00 % 	0
COL Beer_Name VAL Barbarian Red Ale COL Brew_Factory_Name VAL CervecerÃa Barbarian COL Style VAL American Amber / Red Ale COL ABV VAL 6.50 % 	COL Beer_Name VAL Barbarian Red Ale COL Brew_Factory_Name VAL Wildcard Brewing Company COL Style VAL Amber Ale COL ABV VAL 7.50 % 	0
COL Beer_Name VAL Ballistic Brewing Co. - Gorgon Red Ale COL Brew_Factory_Name VAL Indian Wells Brewing Company COL Style VAL American Amber / Red Ale COL ABV VAL 5.50 % 	COL Beer_Name VAL Barrel Aged Series : Barley Wine COL Brew_Factory_Name VAL Elevator Brewing Company COL Style VAL Amber Ale COL ABV VAL 11.80 % 	0
COL Beer_Name VAL Kinetic Infrared Imperial Red Ale COL Brew_Factory_Name VAL Otto 's Pub and Brewery COL Style VAL American Amber / Red Ale COL ABV VAL 6.90 % 	COL Beer_Name VAL Hop Around Imperial Red Ale COL Brew_Factory_Name VAL Kinetic Brewing Company COL Style VAL American Strong Ale COL ABV VAL 9.30 % 	0
COL Beer_Name VAL Vital Infrared Imperial Red COL Brew_Factory_Name VAL Vital Brewing COL Style VAL American Strong Ale COL ABV VAL 9.40 % 	COL Beer_Name VAL Central Coast Old Mission Amber Ale COL Brew_Factory_Name VAL Central Coast Brewing COL Style VAL American Amber / Red Ale COL ABV VAL 9.40 % 	0
COL Beer_Name VAL Excel My Hoppy Valentine COL Brew_Factory_Name VAL Excel Brewing Company COL Style VAL Amber Ale COL ABV VAL 6.50 % 	COL Beer_Name VAL Rocky Mountain Red Ale COL Brew_Factory_Name VAL Grand Lake Brewing Company COL Style VAL American Amber / Red Ale COL ABV VAL - 	0
COL Beer_Name VAL The `` Ginger '' A Red Ale COL Brew_Factory_Name VAL Elk Street Brewery & Tap Room COL Style VAL American Amber / Red Ale COL ABV VAL 6.80 % 	COL Beer_Name VAL The Beer Company Wyatt Earp Red Ale COL Brew_Factory_Name VAL Solemn Oath Brewery COL Style VAL Barley Wine COL ABV VAL 7 % 	0
COL Beer_Name VAL Red 's On Vacation COL Brew_Factory_Name VAL Barley John 's Brew Pub COL Style VAL American Amber / Red Ale COL ABV VAL 5.44 % 	COL Beer_Name VAL Smuttynose Kindest Find Imperial Red Ale COL Brew_Factory_Name VAL Smuttynose Brewing Company COL Style VAL American Strong Ale COL ABV VAL 5.44 % 	0
COL Beer_Name VAL Great Lakes Independence Ale COL Brew_Factory_Name VAL Great Lakes Brewing Co. . COL Style VAL American Amber / Red Ale COL ABV VAL 10 % 	COL Beer_Name VAL Amsterdam X Sawdust City X Great Lakes X Indie Ale Barley Wine &#40; Oak &#41; COL Brew_Factory_Name VAL Amsterdam Brewing Company COL Style VAL Barley Wine COL ABV VAL 17.50 % 	0
COL Beer_Name VAL Oatmeal Amber Ale COL Brew_Factory_Name VAL John Harvard_s Brewhouse &#40; Corporate Office &#41; COL Style VAL American Amber / Red Ale COL ABV VAL 5.70 % 	COL Beer_Name VAL John Harvards Oatmeal Amber Ale COL Brew_Factory_Name VAL Sick N Twisted Brewing Company COL Style VAL Amber Ale COL ABV VAL - 	0
COL Beer_Name VAL River Otter Ale COL Brew_Factory_Name VAL Union Station Brewery COL Style VAL English Pale Ale COL ABV VAL 5.10 % 	COL Beer_Name VAL Buffalo Soul Jah Imperial Red Ale COL Brew_Factory_Name VAL Sacramento Brewing Company COL Style VAL American Amber / Red Ale COL ABV VAL 8.50 % 	0
COL Beer_Name VAL Prohibition Pig Dream of the 90s COL Brew_Factory_Name VAL Prohibition Pig COL Style VAL Amber Ale COL ABV VAL - 	COL Beer_Name VAL Ale Mania Imperial Red Ale COL Brew_Factory_Name VAL Worthy Brewing Co. . COL Style VAL American Strong Ale COL ABV VAL 8.00 % 	0
COL Beer_Name VAL Big Horn Buttface Amber Ale COL Brew_Factory_Name VAL Big Texan Brewery COL Style VAL Amber Ale COL ABV VAL - 	COL Beer_Name VAL Big Texan Texas Red Amber Ale COL Brew_Factory_Name VAL Hops Grillhouse & Brewery COL Style VAL Amber Ale COL ABV VAL 4.50 % 	0
COL Beer_Name VAL Insane Mane Red Ale COL Brew_Factory_Name VAL White Lion Brewing Company COL Style VAL Amber Ale COL ABV VAL 5.10 % 	COL Beer_Name VAL White Lion Insane Mane Red Ale COL Brew_Factory_Name VAL Ipswich Ale Brewery COL Style VAL American Strong Ale COL ABV VAL - 	0
COL Beer_Name VAL Double Mongrel Imperial India Red Ale COL Brew_Factory_Name VAL Aspetuck Brew Lab COL Style VAL American Amber / Red Ale COL ABV VAL 9.00 % 	COL Beer_Name VAL Boxing Cat Firecracker Imperial Red Ale COL Brew_Factory_Name VAL Stone Brewing Co. . COL Style VAL Amber Ale COL ABV VAL 6.60 % 	0
COL Beer_Name VAL Dream Of The 90 's COL Brew_Factory_Name VAL Prohibition Pig COL Style VAL Amber Ale COL ABV VAL - 	COL Beer_Name VAL Fulton The Libertine Imperial Red Ale - Heaven Hill Rye Whiskey Barrel Aged COL Brew_Factory_Name VAL Three Heads Brewing COL Style VAL American Strong Ale COL ABV VAL 9.20 % 	0
COL Beer_Name VAL Clifford The Big Red Ale COL Brew_Factory_Name VAL Books & Brews COL Style VAL American Amber / Red Ale COL ABV VAL 6.70 % 	COL Beer_Name VAL Red Shedman 's Imperial Amber Ale COL Brew_Factory_Name VAL Big Choice Brewing COL Style VAL Amber Ale COL ABV VAL 9.30 % 	0
COL Beer_Name VAL Barrel Aged Imperial Red COL Brew_Factory_Name VAL Hale 's Ales Brewery & Pub COL Style VAL American Amber / Red Ale COL ABV VAL 9.00 % 	COL Beer_Name VAL Imperial Oak Barrel Aged Odin_s Beard COL Brew_Factory_Name VAL Prohibition Pig COL Style VAL American Strong Ale COL ABV VAL 9 % 	0
COL Beer_Name VAL Eldred Rock Amber COL Brew_Factory_Name VAL Haines Brewing Co. . COL Style VAL American Amber / Red Ale COL ABV VAL 5 % 	COL Beer_Name VAL Haines Eldred Rock Amber COL Brew_Factory_Name VAL Laurelwood Public House & Brewery COL Style VAL Amber Ale COL ABV VAL 9.50 % 	0
COL Beer_Name VAL Kuhnhenn Extraneous Ale COL Brew_Factory_Name VAL Kuhnhenn Brewing COL Style VAL Barley Wine COL ABV VAL 17.00 % 	COL Beer_Name VAL Good People Stepchild Belgian India Red Ale COL Brew_Factory_Name VAL 7 Fjell Bryggeri COL Style VAL American Amber / Red Ale COL ABV VAL 17.50 % 	0
COL Beer_Name VAL Lagunitas Imperial Red Ale COL Brew_Factory_Name VAL Lagunitas Brewing Company COL Style VAL Amber Ale COL ABV VAL 7.80 % 	COL Beer_Name VAL Two Brothers Revelry Imperial Red Ale COL Brew_Factory_Name VAL Sick N Twisted Brewing Company COL Style VAL American Amber / Red Ale COL ABV VAL 8 % 	0
COL Beer_Name VAL Mountain Series : Love Rhino ( Imperial Red Ale ) COL Brew_Factory_Name VAL Breckenridge Brewery COL Style VAL American Amber / Red Ale COL ABV VAL 8.90 % 	COL Beer_Name VAL John Harvards Oatmeal Amber Ale COL Brew_Factory_Name VAL John Harvard_s Brewhouse &#40; Corporate Office &#41; COL Style VAL Amber Ale COL ABV VAL 7.20 % 	0
COL Beer_Name VAL Pints Rip Saw Red COL Brew_Factory_Name VAL Pints Brewing Co. . COL Style VAL American Amber / Red Ale COL ABV VAL 6.50 % 	COL Beer_Name VAL Ballast Point Tongue Buckler Imperial Red Ale COL Brew_Factory_Name VAL Pints Brewing Company COL Style VAL American Amber / Red Ale COL ABV VAL 5.90 % 	0
COL Beer_Name VAL American Red Ale COL Brew_Factory_Name VAL Rock Art Brewery COL Style VAL Amber Ale COL ABV VAL 4.80 % 	COL Beer_Name VAL Mountain Series : Love Rhino ( Imperial Red Ale ) COL Brew_Factory_Name VAL Americas Brewpub COL Style VAL American Strong Ale COL ABV VAL - 	0
COL Beer_Name VAL MadTree Bourbon Barrel Aged Happy Amber COL Brew_Factory_Name VAL MadTree Brewing Company COL Style VAL Amber Ale COL ABV VAL 6 % 	COL Beer_Name VAL Crazy Mountain Boohai Red Ale &#40; Kura Koa &#41; COL Brew_Factory_Name VAL Crazy Mountain Brewing Company COL Style VAL Amber Ale COL ABV VAL 6.00 % 	0
COL Beer_Name VAL Poor Richard 's Ale COL Brew_Factory_Name VAL Dry Dock Brewing Co. . COL Style VAL American Amber / Red Ale COL ABV VAL 7 % 	COL Beer_Name VAL 21st Amendment Poor Richards Ale COL Brew_Factory_Name VAL Kinetic Brewing Company COL Style VAL American Amber / Red Ale COL ABV VAL 9.30 % 	0
COL Beer_Name VAL Rockyard Blarney Rock Irish Ale COL Brew_Factory_Name VAL Rockyard Brewing Company COL Style VAL Irish Ale COL ABV VAL 6.00 % 	COL Beer_Name VAL Shark Attack Double Red Ale COL Brew_Factory_Name VAL Midnight Sun Brewing Company COL Style VAL Amber Ale COL ABV VAL 9.00 % 	0
COL Beer_Name VAL Mad River Jamaica Red Ale COL Brew_Factory_Name VAL Mad Anthony Brewing Company COL Style VAL Amber Ale COL ABV VAL - 	COL Beer_Name VAL Barrel Aged Moustache Ride Red COL Brew_Factory_Name VAL Fulton Beer Company COL Style VAL American Strong Ale COL ABV VAL 6.50 % 	0
COL Beer_Name VAL Boohai Red Ale COL Brew_Factory_Name VAL Crazy Mountain Brewing Company COL Style VAL American Amber / Red Ale COL ABV VAL 6 % 	COL Beer_Name VAL Engine House No. 9 Rowdy Dick Amber Ale COL Brew_Factory_Name VAL Crazy Mountain Brewing Company COL Style VAL Amber Ale COL ABV VAL 5.30 % 	0
COL Beer_Name VAL Insane Mane Red Ale COL Brew_Factory_Name VAL White Lion Brewing Company COL Style VAL American Amber / Red Ale COL ABV VAL 5.10 % 	COL Beer_Name VAL White Lion Insane Mane Red Ale COL Brew_Factory_Name VAL Ipswich Ale Brewery COL Style VAL Amber Ale COL ABV VAL - 	0
COL Beer_Name VAL Merry Prankster Imperial Red Ale COL Brew_Factory_Name VAL Rock Bottom Restaurant & Brewery COL Style VAL American Amber / Red Ale COL ABV VAL 4.56 % 	COL Beer_Name VAL Prohibition Pig Dream of the 90s COL Brew_Factory_Name VAL Tumbledown Brewing LLC COL Style VAL American Amber / Red Ale COL ABV VAL 6.10 % 	0
COL Beer_Name VAL Brewmaster 's Reserve Imperial Red Ale COL Brew_Factory_Name VAL Rock Bottom Orland Park COL Style VAL American Amber / Red Ale COL ABV VAL 9.20 % 	COL Beer_Name VAL Rock Bottom Orland Park King of Hearts Imperial Red Ale COL Brew_Factory_Name VAL Kinetic Brewing Company COL Style VAL American Strong Ale COL ABV VAL 7.60 % 	0
COL Beer_Name VAL Dream Of The 90 's COL Brew_Factory_Name VAL Prohibition Pig COL Style VAL Amber Ale COL ABV VAL 6.10 % 	COL Beer_Name VAL Prohibition Pig Dream of the 90s COL Brew_Factory_Name VAL Hangar 24 Craft Brewery COL Style VAL Barley Wine COL ABV VAL - 	0
COL Beer_Name VAL Crazy Mountain Boohai Red Ale &#40; Kura Koa &#41; COL Brew_Factory_Name VAL Crazy Mountain Brewing Company COL Style VAL American Amber / Red Ale COL ABV VAL 6 % 	COL Beer_Name VAL Winter Seasonal Amber Ale COL Brew_Factory_Name VAL Dead Frog Brewing COL Style VAL Amber Ale COL ABV VAL 6 % 	0
COL Beer_Name VAL Double Red Hot Ale COL Brew_Factory_Name VAL Destihl Brewery COL Style VAL American Amber / Red Ale COL ABV VAL 7.57 % 	COL Beer_Name VAL Sick N Twisted Naughty Redhead Imperial Red Ale COL Brew_Factory_Name VAL Lagunitas Brewing Company COL Style VAL American Amber / Red Ale COL ABV VAL - 	0
COL Beer_Name VAL Shirt Tail Amber COL Brew_Factory_Name VAL Iron Hill Brewery & Restaurant COL Style VAL American Amber / Red Ale COL ABV VAL 4.40 % 	COL Beer_Name VAL Iron Hill Shirt Tail Amber COL Brew_Factory_Name VAL Barley_s Brewing Company COL Style VAL Amber Ale COL ABV VAL 4.40 % 	0
COL Beer_Name VAL Blarney Rock Irish Ale COL Brew_Factory_Name VAL Rockyard Brewing COL Style VAL American Amber / Red Ale COL ABV VAL 6.00 % 	COL Beer_Name VAL Molly American Red Ale COL Brew_Factory_Name VAL Rockyard Brewing Company COL Style VAL Irish Ale COL ABV VAL - 	0
COL Beer_Name VAL Copperhead Amber Ale COL Brew_Factory_Name VAL Yalobusha Brewing Company COL Style VAL American Amber / Red Ale COL ABV VAL 5.60 % 	COL Beer_Name VAL Yalobusha Copperhead Amber Ale COL Brew_Factory_Name VAL Yalobusha Brewing Company COL Style VAL Amber Ale COL ABV VAL 8.80 % 	0
COL Beer_Name VAL Slanted Rock Iron Butt Red Ale COL Brew_Factory_Name VAL OPA-OPA Steakhouse & Brewery COL Style VAL American Amber / Red Ale COL ABV VAL 5.80 % 	COL Beer_Name VAL Prohibition Pig Dream of the 90s COL Brew_Factory_Name VAL Slanted Rock Brewing Company COL Style VAL Amber Ale COL ABV VAL - 	0
COL Beer_Name VAL The Gentle Mongoose COL Brew_Factory_Name VAL Holy City Brewing COL Style VAL American Amber / Red Ale COL ABV VAL 6.90 % 	COL Beer_Name VAL Holy City The Gentle Mongoose COL Brew_Factory_Name VAL Holy City Brewing COL Style VAL Amber Ale COL ABV VAL 6.90 % 	0
COL Beer_Name VAL Mountain Town Cow Catcher Red Ale COL Brew_Factory_Name VAL Mountain Town Station Brewing Co. & Steakhouse COL Style VAL American Amber / Red Ale COL ABV VAL - 	COL Beer_Name VAL Worthy Eruption Imperial Red Ale COL Brew_Factory_Name VAL Mountain Town Brewing Company COL Style VAL American Strong Ale COL ABV VAL 5.80 % 	0
COL Beer_Name VAL Trail Ridge Red COL Brew_Factory_Name VAL Estes Park Brewery COL Style VAL American Amber / Red Ale COL ABV VAL 7.50 % 	COL Beer_Name VAL Pizza Orgasmica Amber Ale COL Brew_Factory_Name VAL Pizza Port &#40; Solana Beach &#41; COL Style VAL Bitter COL ABV VAL 4.50 % 	0
COL Beer_Name VAL Holy City The Gentle Mongoose COL Brew_Factory_Name VAL Holy City Brewing COL Style VAL American Amber / Red Ale COL ABV VAL 6.90 % 	COL Beer_Name VAL Noggin Floggin ( Bourbon Barrel Aged ) COL Brew_Factory_Name VAL Holy City Brewing COL Style VAL Amber Ale COL ABV VAL 6 % 	0
COL Beer_Name VAL Double Dragon Imperial Red Ale COL Brew_Factory_Name VAL Edge Brewing Company COL Style VAL American Strong Ale COL ABV VAL 8.20 % 	COL Beer_Name VAL Edge Imperial Red Ale &#40; Spring Seasonal &#41; COL Brew_Factory_Name VAL John Harvard_s Brewhouse &#40; Corporate Office &#41; COL Style VAL American Amber / Red Ale COL ABV VAL 8.50 % 	0
COL Beer_Name VAL Tumbledown Imp Imperial Red Ale COL Brew_Factory_Name VAL Redwood Lodge COL Style VAL American Amber / Red Ale COL ABV VAL 8.10 % 	COL Beer_Name VAL Peak Organic The Maple Collaboration COL Brew_Factory_Name VAL Tumbledown Brewing LLC COL Style VAL American Strong Ale COL ABV VAL 7.80 % 	0
COL Beer_Name VAL Driftwood Old Cellar Dweller Barleywine COL Brew_Factory_Name VAL Driftwood Brewery &#40; Canada &#41; COL Style VAL American Barleywine COL ABV VAL 11.60 % 	COL Beer_Name VAL Red Hopper ( Imperial Red Ale ) COL Brew_Factory_Name VAL Worthy Brewing Company COL Style VAL Barley Wine COL ABV VAL 8 % 	0
COL Beer_Name VAL Freedom Soho Red COL Brew_Factory_Name VAL Freedom COL Style VAL Amber Lager/Vienna COL ABV VAL 4.70 % 	COL Beer_Name VAL Red Dirt Imperial Red Ale COL Brew_Factory_Name VAL Ballast Point Brewing Company COL Style VAL American Amber / Red Ale COL ABV VAL 10 % 	0
COL Beer_Name VAL Cow Catcher Red COL Brew_Factory_Name VAL Mountain Town Station Brewing Co. & Steakhouse COL Style VAL American Amber / Red Ale COL ABV VAL - 	COL Beer_Name VAL 6th Anniversary Ale ( Dirty Hippie Imperial Red Ale ) COL Brew_Factory_Name VAL Mountain Town Brewing Company COL Style VAL American Amber / Red Ale COL ABV VAL 5.80 % 	0
COL Beer_Name VAL Fullers Traitors ' Gate COL Brew_Factory_Name VAL Fuller Smith & Turner PLC COL Style VAL American Amber / Red Ale COL ABV VAL 4.50 % 	COL Beer_Name VAL Fuller_s Traitor_s Gate COL Brew_Factory_Name VAL Purrumbete Brewing COL Style VAL Amber Ale COL ABV VAL 4.50 % 	0
COL Beer_Name VAL Merry Prankster Imperial Red Ale COL Brew_Factory_Name VAL Tumbledown Brewing LLC COL Style VAL American Amber / Red Ale COL ABV VAL 4.56 % 	COL Beer_Name VAL Tumbledown Imp Imperial Red Ale COL Brew_Factory_Name VAL Howe Sound Inn & Brewing Company COL Style VAL American Strong Ale COL ABV VAL 7.80 % 	0
COL Beer_Name VAL Red Shedman 's Imperial Amber Ale COL Brew_Factory_Name VAL Kinetic Brewing Company COL Style VAL American Amber / Red Ale COL ABV VAL 7.60 % 	COL Beer_Name VAL Kinetic Infrared Imperial Red Ale COL Brew_Factory_Name VAL Swashbuckler Brewing Company COL Style VAL American Strong Ale COL ABV VAL 9.30 % 	0
COL Beer_Name VAL Roundabout Imperial Red Ale COL Brew_Factory_Name VAL Bonfire Brewing Co. . COL Style VAL American Amber / Red Ale COL ABV VAL 8.80 % 	COL Beer_Name VAL Anacapa Riptide Imperial Red Ale COL Brew_Factory_Name VAL Oskar Blues Grill & Brew COL Style VAL American Amber / Red Ale COL ABV VAL 8 % 	0
COL Beer_Name VAL Double Dread Imperial Red Ale COL Brew_Factory_Name VAL Mad River Brewing Company COL Style VAL American Strong Ale COL ABV VAL 8.60 % 	COL Beer_Name VAL Bacchus / Burrow Bloodhound Blood Red IPA COL Brew_Factory_Name VAL Bacchus Brewing Company &#40; Australia &#41; COL Style VAL India Pale Ale &#40; IPA &#41; COL ABV VAL 7.00 % 	0
COL Beer_Name VAL Barbarian Red Ale COL Brew_Factory_Name VAL CervecerÃa Barbarian COL Style VAL American Amber / Red Ale COL ABV VAL 6.50 % 	COL Beer_Name VAL Barbarian Red Ale COL Brew_Factory_Name VAL CervecerÃa Barbarian COL Style VAL Amber Ale COL ABV VAL 9.10 % 	0
COL Beer_Name VAL Fullers Traitors ' Gate COL Brew_Factory_Name VAL Fuller Smith & Turner PLC COL Style VAL Bitter COL ABV VAL 4.50 % 	COL Beer_Name VAL Double Dread Imperial Red Ale COL Brew_Factory_Name VAL Fuller_s COL Style VAL American Strong Ale COL ABV VAL 4.50 % 	0
COL Beer_Name VAL Molly American Red Ale COL Brew_Factory_Name VAL New Helvetia Brewing Company COL Style VAL Amber Ale COL ABV VAL 5.00 % 	COL Beer_Name VAL Genesee Brew House American Red Ale COL Brew_Factory_Name VAL Liquid Mechanics Brewing Co. . COL Style VAL American Amber / Red Ale COL ABV VAL 5 % 	0
COL Beer_Name VAL Scuttlebutt Mateo Loco Imperial Red Ale COL Brew_Factory_Name VAL Scuttlebutt Brewing Co. . COL Style VAL American Strong Ale COL ABV VAL 8.60 % 	COL Beer_Name VAL Tumbledown Imp Imperial Red Ale COL Brew_Factory_Name VAL Breckenridge Brewery COL Style VAL American Strong Ale COL ABV VAL 7.10 % 	0
COL Beer_Name VAL Double Dragon Imperial Red Ale COL Brew_Factory_Name VAL Phillips Brewing Company COL Style VAL American Amber / Red Ale COL ABV VAL 8.20 % 	COL Beer_Name VAL Edge Imperial Red Ale &#40; Spring Seasonal &#41; COL Brew_Factory_Name VAL Edge Brewing Company COL Style VAL American Strong Ale COL ABV VAL 8.50 % 	0
COL Beer_Name VAL Big Time Lift Ticket American Red Ale COL Brew_Factory_Name VAL New Helvetia Brewing Company COL Style VAL American Amber / Red Ale COL ABV VAL 5.00 % 	COL Beer_Name VAL White Lion Insane Mane Red Ale COL Brew_Factory_Name VAL White Lion Brewing Company COL Style VAL India Pale Ale &#40; IPA &#41; COL ABV VAL 7 % 	0
COL Beer_Name VAL Mountain Series : Love Rhino ( Imperial Red Ale ) COL Brew_Factory_Name VAL Breckenridge Brewery COL Style VAL American Strong Ale COL ABV VAL 8.90 % 	COL Beer_Name VAL Tumbledown Imp Imperial Red Ale COL Brew_Factory_Name VAL CervecerÃa Barbarian COL Style VAL Amber Ale COL ABV VAL 7.80 % 	0
COL Beer_Name VAL Estes Park Trail Ridge Red COL Brew_Factory_Name VAL Grand Lake Brewing Company COL Style VAL American Amber / Red Ale COL ABV VAL 7.50 % 	COL Beer_Name VAL Blood On The Blade Red IPA COL Brew_Factory_Name VAL Estes Park Brewery COL Style VAL Bitter COL ABV VAL 4.50 % 	0
COL Beer_Name VAL Broadhead Bourbon Barrel Aged Red COL Brew_Factory_Name VAL Bainbridge Island Brewing Company COL Style VAL American Amber / Red Ale COL ABV VAL 8.50 % 	COL Beer_Name VAL Flat 12 Barrel Aged Moustache Ride Red COL Brew_Factory_Name VAL Purrumbete Brewing COL Style VAL American Amber / Red Ale COL ABV VAL - 	0
COL Beer_Name VAL Ro Shampo Imperial Red Ale COL Brew_Factory_Name VAL Figure 8 Brewing COL Style VAL American Amber / Red Ale COL ABV VAL 7.50 % 	COL Beer_Name VAL Ballast Point Tongue Buckler Imperial Red Ale - Bourbon Barrel Aged COL Brew_Factory_Name VAL Ballast Point Brewing Company COL Style VAL American Strong Ale COL ABV VAL 10 % 	0
COL Beer_Name VAL Buffalo Soul Jah Imperial Red Ale COL Brew_Factory_Name VAL Three Heads Brewing COL Style VAL American Amber / Red Ale COL ABV VAL 9.20 % 	COL Beer_Name VAL Fulton The Libertine Imperial Red Ale - Heaven Hill Rye Whiskey Barrel Aged COL Brew_Factory_Name VAL Fulton Beer Company COL Style VAL American Strong Ale COL ABV VAL 9.40 % 	0
COL Beer_Name VAL Kern River Dirty Hippie Imperial Red Ale COL Brew_Factory_Name VAL Great River Brewery COL Style VAL American Strong Ale COL ABV VAL 9.00 % 	COL Beer_Name VAL Kinetic Infrared Imperial Red Ale COL Brew_Factory_Name VAL Kern River Brewing COL Style VAL American Amber / Red Ale COL ABV VAL 8.60 % 	0
COL Beer_Name VAL Unite Red Rye Ale COL Brew_Factory_Name VAL The Pike Brewing Company COL Style VAL American Amber / Red Ale COL ABV VAL 4.60 % 	COL Beer_Name VAL Pike Unite Red Rye Ale COL Brew_Factory_Name VAL Pike Brewing Company COL Style VAL Amber Ale COL ABV VAL 8.00 % 	0
COL Beer_Name VAL Barrel Aged Imperial Red Ale COL Brew_Factory_Name VAL Boone Valley Brewing COL Style VAL American Amber / Red Ale COL ABV VAL 9.99 % 	COL Beer_Name VAL Laurelwood Organic Deranger Imperial Red Ale COL Brew_Factory_Name VAL Laurelwood Public House & Brewery COL Style VAL American Strong Ale COL ABV VAL 5.00 % 	0
COL Beer_Name VAL The Gentle Mongoose COL Brew_Factory_Name VAL Holy City Brewing COL Style VAL American Amber / Red Ale COL ABV VAL 6.90 % 	COL Beer_Name VAL Hammond River Red Coat India Red Ale COL Brew_Factory_Name VAL Holy City Brewing COL Style VAL Amber Ale COL ABV VAL 6.50 % 	0
COL Beer_Name VAL Arsenal Imperial Red Ale COL Brew_Factory_Name VAL Great River Brewery COL Style VAL American Amber / Red Ale COL ABV VAL 9.00 % 	COL Beer_Name VAL Kern River Dirty Hippie Imperial Red Ale COL Brew_Factory_Name VAL Kern River Brewing COL Style VAL American Strong Ale COL ABV VAL - 	0
COL Beer_Name VAL Bourbon Barrel Aged Panama Red Ale COL Brew_Factory_Name VAL Flossmoor Station Restaurant & Brewery COL Style VAL American Amber / Red Ale COL ABV VAL 7.00 % 	COL Beer_Name VAL AleSmith Old Numbskull - Bourbon Barrel Aged COL Brew_Factory_Name VAL AleSmith Brewing Company COL Style VAL Barley Wine COL ABV VAL 11 % 	0
COL Beer_Name VAL Double Dread Imperial Red Ale COL Brew_Factory_Name VAL Mad River Brewing Company COL Style VAL American Amber / Red Ale COL ABV VAL 8.60 % 	COL Beer_Name VAL Ballast Point Tongue Buckler Imperial Red Ale COL Brew_Factory_Name VAL Ballast Point Brewing Company COL Style VAL Barley Wine COL ABV VAL 17.50 % 	0
COL Beer_Name VAL Sons Of Anarchy Amber Ale COL Brew_Factory_Name VAL Sudwerk Brewing Company COL Style VAL Amber Ale COL ABV VAL 4.70 % 	COL Beer_Name VAL Sudwerk Sons Of Anarchy Amber Ale COL Brew_Factory_Name VAL Sudwerk Brewing Company COL Style VAL Amber Ale COL ABV VAL 4.70 % 	0
COL Beer_Name VAL Hawai'i Nui Sunset Amber Ale COL Brew_Factory_Name VAL Hawai'i Nui Brewing / Mehana Brewing Company COL Style VAL Amber Ale COL ABV VAL 5.45 % 	COL Beer_Name VAL Grand Canyon Sunset Amber Ale COL Brew_Factory_Name VAL Grand Canyon Brewing Company COL Style VAL American Amber / Red Ale COL ABV VAL 5 % 	0
COL Beer_Name VAL Barrel Aged Red Ale COL Brew_Factory_Name VAL BearWaters Brewing Co. . COL Style VAL American Amber / Red Ale COL ABV VAL 8.60 % 	COL Beer_Name VAL Barley_s Barrel Aged Ulysses Imperial Red Ale COL Brew_Factory_Name VAL Barley_s Brewing Company COL Style VAL American Strong Ale COL ABV VAL - 	0
COL Beer_Name VAL Strada S. Felice COL Brew_Factory_Name VAL Grado Plato COL Style VAL American Amber / Red Ale COL ABV VAL 8 % 	COL Beer_Name VAL Grado Plato Strada S. Felice COL Brew_Factory_Name VAL Birrificio Grado Plato COL Style VAL Spice/Herb/Vegetable COL ABV VAL 8.80 % 	0
COL Beer_Name VAL Laurelwood Organic Deranger Imperial Red Ale COL Brew_Factory_Name VAL Boone Valley Brewing COL Style VAL American Strong Ale COL ABV VAL 9.99 % 	COL Beer_Name VAL Midnight Sun Unite Double Red Hot Ale &#40; 2015 &#41; COL Brew_Factory_Name VAL Midnight Sun Brewing Company COL Style VAL American Amber / Red Ale COL ABV VAL 8.60 % 	0
COL Beer_Name VAL Fisherman 's Tea Party COL Brew_Factory_Name VAL Cape Ann Brewing Company COL Style VAL American Barleywine COL ABV VAL 9.00 % 	COL Beer_Name VAL Cape Ann Fisherman_s Tea Party COL Brew_Factory_Name VAL Stone Brewing Co. . COL Style VAL Barley Wine COL ABV VAL 9 % 	0
COL Beer_Name VAL Eldred Rock Amber COL Brew_Factory_Name VAL Haines Brewing Co. . COL Style VAL Amber Ale COL ABV VAL 5.00 % 	COL Beer_Name VAL Tumbledown Imp Imperial Red Ale COL Brew_Factory_Name VAL Bonfire Brewing Co. . COL Style VAL American Amber / Red Ale COL ABV VAL 5 % 	0
COL Beer_Name VAL Freedom Soho Red COL Brew_Factory_Name VAL Freedom Brewery Ltd COL Style VAL American Amber / Red Ale COL ABV VAL 4.70 % 	COL Beer_Name VAL Edge Imperial Red Ale &#40; Spring Seasonal &#41; COL Brew_Factory_Name VAL Freedom COL Style VAL American Strong Ale COL ABV VAL 4.70 % 	0
COL Beer_Name VAL Red-oric - Beer Camp # 65 ( Best Of Beer Camp : Imperial Red Ale ) COL Brew_Factory_Name VAL Sierra Nevada Brewing Co. . COL Style VAL American Amber / Red Ale COL ABV VAL 9.50 % 	COL Beer_Name VAL Two Brothers Revelry Imperial Red Ale COL Brew_Factory_Name VAL Railway City Brewing Company COL Style VAL American Strong Ale COL ABV VAL 4.60 % 	0
COL Beer_Name VAL BJ 's Imperial Red Ale COL Brew_Factory_Name VAL Fulton Beer Company COL Style VAL American Amber / Red Ale COL ABV VAL 8.50 % 	COL Beer_Name VAL Fulton The Libertine Imperial Red Ale - Heaven Hill Rye Whiskey Barrel Aged COL Brew_Factory_Name VAL Heavy Seas Brewing Company COL Style VAL American Amber / Red Ale COL ABV VAL 6.00 % 	0
COL Beer_Name VAL Eruption Imperial Red Ale COL Brew_Factory_Name VAL Custom Brewcrafters COL Style VAL American Amber / Red Ale COL ABV VAL 8.00 % 	COL Beer_Name VAL Three Heads Buffalo Soul Jah Imperial Red Ale COL Brew_Factory_Name VAL Dark Horse Brewing Company COL Style VAL American Strong Ale COL ABV VAL 5.50 % 	0
COL Beer_Name VAL Ro Shampo Imperial Red Ale COL Brew_Factory_Name VAL Figure 8 Brewing COL Style VAL American Amber / Red Ale COL ABV VAL 7.50 % 	COL Beer_Name VAL Fuller_s Traitor_s Gate COL Brew_Factory_Name VAL Fuller Smith & Turner PLC COL Style VAL American Amber / Red Ale COL ABV VAL 8 % 	0
COL Beer_Name VAL Heavyweight Ticklefight Champion Of The World COL Brew_Factory_Name VAL Solemn Oath Brewery COL Style VAL American Barleywine COL ABV VAL 12.00 % 	COL Beer_Name VAL Solemn Oath Heavyweight Ticklefight Champion of the World COL Brew_Factory_Name VAL Aspen Brewing Company COL Style VAL Amber Ale COL ABV VAL 11.00 % 	0
COL Beer_Name VAL Kingpin Double Red Ale COL Brew_Factory_Name VAL BridgePort Brewing Co. / Brewpub COL Style VAL American Amber / Red Ale COL ABV VAL 7.50 % 	COL Beer_Name VAL Out of Bounds Relentless Double Red Ale COL Brew_Factory_Name VAL CervecerÃa Barbarian COL Style VAL American Strong Ale COL ABV VAL 8.20 % 	0
COL Beer_Name VAL Double Red Hot Ale COL Brew_Factory_Name VAL Midnight Sun Brewing Co. . COL Style VAL American Amber / Red Ale COL ABV VAL 7.57 % 	COL Beer_Name VAL Unite Red Rye Ale COL Brew_Factory_Name VAL The Pike Brewing Company COL Style VAL American Strong Ale COL ABV VAL 4.60 % 	0
COL Beer_Name VAL Rip Saw Red COL Brew_Factory_Name VAL Pints Brewing Co. . COL Style VAL Amber Ale COL ABV VAL 5.90 % 	COL Beer_Name VAL Pints Rip Saw Red COL Brew_Factory_Name VAL Rock Bottom Orland Park COL Style VAL American Amber / Red Ale COL ABV VAL 7.60 % 	0
COL Beer_Name VAL Saint Gleason Imperial Red Ale COL Brew_Factory_Name VAL Abita Brewing Co. . COL Style VAL American Amber / Red Ale COL ABV VAL - 	COL Beer_Name VAL Hermit Thrush Abbey Series # 1 - Jolly Abbot Barley Wine COL Brew_Factory_Name VAL Mission Brewery COL Style VAL American Strong Ale COL ABV VAL 10.20 % 	0
COL Beer_Name VAL Smuttynose Kindest Find Imperial Red Ale COL Brew_Factory_Name VAL Smuttynose Brewing Company COL Style VAL American Amber / Red Ale COL ABV VAL 8.50 % 	COL Beer_Name VAL Red 's On Vacation COL Brew_Factory_Name VAL Kettle House Brewing Company COL Style VAL Amber Ale COL ABV VAL 13 % 	0
COL Beer_Name VAL My Hoppy Valentine COL Brew_Factory_Name VAL Excel Brewing Company COL Style VAL Amber Ale COL ABV VAL 6.50 % 	COL Beer_Name VAL Lavery Imperial Red Ale COL Brew_Factory_Name VAL Excel Brewing Company COL Style VAL American Amber / Red Ale COL ABV VAL 8.20 % 	0
COL Beer_Name VAL John Harvards Oatmeal Amber Ale COL Brew_Factory_Name VAL Ornery Beer Company Public House COL Style VAL American Amber / Red Ale COL ABV VAL 5.70 % 	COL Beer_Name VAL Pokertree Red Earl Ruby Ale COL Brew_Factory_Name VAL Pokertree COL Style VAL Amber Ale COL ABV VAL 4.00 % 	0
COL Beer_Name VAL Starfish Imperial Red Ale COL Brew_Factory_Name VAL Worthy Brewing Company COL Style VAL American Amber / Red Ale COL ABV VAL 7.50 % 	COL Beer_Name VAL Worthy Eruption Imperial Red Ale COL Brew_Factory_Name VAL West Sixth Brewing Company COL Style VAL American Amber / Red Ale COL ABV VAL 8 % 	0
