COL Beer_Name VAL Bourbon Barrel Aged Horus Imperial Red COL Brew_Factory_Name VAL Stilt House Brewery COL Style VAL American Amber / Red Ale COL ABV VAL 8.30 %  	COL Beer_Name VAL Madhouse Venture Series Oak Aged Imperial Red COL Brew_Factory_Name VAL Midnight Sun Brewing Company COL Style VAL Amber Ale COL ABV VAL -  	0 
COL Beer_Name VAL Frog Island Amber Ale COL Brew_Factory_Name VAL The Dodging Duck Brewhaus COL Style VAL American Amber / Red Ale COL ABV VAL -  	COL Beer_Name VAL Anderson Valley Barrel Aged Horn of the Beer Barley Wine COL Brew_Factory_Name VAL Brouwerij De Koninck &#40; Duvel-Moortgat &#41; COL Style VAL Amber Ale COL ABV VAL 6.50 %  	0 
COL Beer_Name VAL Vital Infrared Imperial Red COL Brew_Factory_Name VAL Vital Brewing COL Style VAL American Amber / Red Ale COL ABV VAL 9.40 %  	COL Beer_Name VAL Vital Infrared Imperial Red COL Brew_Factory_Name VAL Vital Brewing COL Style VAL American Strong Ale COL ABV VAL 9.40 %  	1 
COL Beer_Name VAL Winter Seasonal Amber Ale COL Brew_Factory_Name VAL Hopworks Urban Brewery COL Style VAL American Barleywine COL ABV VAL 4.00 %  	COL Beer_Name VAL MadTree Bourbon Barrel Aged Happy Amber COL Brew_Factory_Name VAL MadTree Brewing Company COL Style VAL Amber Ale COL ABV VAL 6 %  	0 
COL Beer_Name VAL Imperial Red Ale COL Brew_Factory_Name VAL Figure 8 Brewing COL Style VAL American Amber / Red Ale COL ABV VAL 7.80 %  	COL Beer_Name VAL Ballast Point Tongue Buckler Imperial Red Ale COL Brew_Factory_Name VAL Genesee Brewing Company &#40; North American Breweries &#41; COL Style VAL Barley Wine COL ABV VAL -  	0 
COL Beer_Name VAL Molly American Red Ale COL Brew_Factory_Name VAL New Helvetia Brewing Company COL Style VAL American Amber / Red Ale COL ABV VAL 5.00 %  	COL Beer_Name VAL The Beer Company Wyatt Earp Red Ale COL Brew_Factory_Name VAL Big Time Brewery COL Style VAL Irish Ale COL ABV VAL 7 %  	0 
COL Beer_Name VAL Mr. Grain Jeans Organic Amber Ale COL Brew_Factory_Name VAL The Dodging Duck Brewhaus COL Style VAL American Amber / Red Ale COL ABV VAL -  	COL Beer_Name VAL Yukon You Only Live Once Imperial Red Ale COL Brew_Factory_Name VAL Canal Park Brewing Company COL Style VAL Amber Ale COL ABV VAL 6.50 %  	0 
COL Beer_Name VAL Iron Mike 's Amber Ale COL Brew_Factory_Name VAL Wolf Hills Brewing Company COL Style VAL American Amber / Red Ale COL ABV VAL -  	COL Beer_Name VAL Blue Pants Big & Tall # 2 : Barrel Aged Belgian Red COL Brew_Factory_Name VAL Stadin Panimo COL Style VAL Amber Ale COL ABV VAL 6 %  	0 
COL Beer_Name VAL Stupiphany Imperial Red Ale COL Brew_Factory_Name VAL Bainbridge Island Brewing Company COL Style VAL American Amber / Red Ale COL ABV VAL 8.00 %  	COL Beer_Name VAL Lavery Imperial Red Ale &#40; IRA &#41; COL Brew_Factory_Name VAL Cigar City Brewing COL Style VAL Amber Ale COL ABV VAL 5 %  	0 
COL Beer_Name VAL Big Bear Amber Ale COL Brew_Factory_Name VAL C.B. & Potts COL Style VAL American Amber / Red Ale COL ABV VAL 7.00 %  	COL Beer_Name VAL Aspen Bourbon Barrel Aged Conundrum Red Ale COL Brew_Factory_Name VAL Big Texan Brewery COL Style VAL Amber Ale COL ABV VAL 6 %  	0 
COL Beer_Name VAL 6th Anniversary Ale ( Dirty Hippie Imperial Red Ale ) COL Brew_Factory_Name VAL Aspetuck Brew Lab COL Style VAL American Amber / Red Ale COL ABV VAL -  	COL Beer_Name VAL Brew Bus Detour Series : Rollin Dirty Red Ale - Wood Aged COL Brew_Factory_Name VAL Cigar City Brewing COL Style VAL Irish Ale COL ABV VAL 5 %  	0 
COL Beer_Name VAL Big Bully Amber Ale COL Brew_Factory_Name VAL New Helvetia Brewing Company COL Style VAL American Amber / Red Ale COL ABV VAL -  	COL Beer_Name VAL Big Texan Texas Red Amber Ale COL Brew_Factory_Name VAL Big Spruce Brewing COL Style VAL Amber Ale COL ABV VAL 4.80 %  	0 
COL Beer_Name VAL Harold The Red Ale COL Brew_Factory_Name VAL Wolf Hills Brewing Company COL Style VAL American Amber / Red Ale COL ABV VAL -  	COL Beer_Name VAL Squatters Respect Your Mother Organic Amber Ale COL Brew_Factory_Name VAL Pokertree COL Style VAL Amber Ale COL ABV VAL 5.50 %  	0 
COL Beer_Name VAL 6th Anniversary Ale ( Dirty Hippie Imperial Red Ale ) COL Brew_Factory_Name VAL Mountain Goat Beer Pty Ltd COL Style VAL American Amber / Red Ale COL ABV VAL -  	COL Beer_Name VAL Brew Bus Detour Series : Rollin Dirty Red Ale - Wood Aged COL Brew_Factory_Name VAL Cigar City Brewing COL Style VAL Irish Ale COL ABV VAL 5 %  	0 
COL Beer_Name VAL Barrel Aged Red Ale COL Brew_Factory_Name VAL The Civil Life Brewing Company COL Style VAL American Amber / Red Ale COL ABV VAL -  	COL Beer_Name VAL Spring House Atomic Raygun Imperial Red Ale COL Brew_Factory_Name VAL William Street Beer Co. . COL Style VAL Amber Ale COL ABV VAL 6.70 %  	0 
COL Beer_Name VAL All American Red Ale COL Brew_Factory_Name VAL Boston Beer Works - Canal Street COL Style VAL American Amber / Red Ale COL ABV VAL -  	COL Beer_Name VAL Oak Creek King Crimson Imperial Red Ale COL Brew_Factory_Name VAL Cigar City Brewing COL Style VAL Amber Ale COL ABV VAL 11 %  	0 
COL Beer_Name VAL Imperial Red Ale COL Brew_Factory_Name VAL Mountain Goat Beer Pty Ltd COL Style VAL American Amber / Red Ale COL ABV VAL -  	COL Beer_Name VAL Aspen Bourbon Barrel Aged Conundrum Red Ale COL Brew_Factory_Name VAL Central Coast Brewing COL Style VAL Amber Ale COL ABV VAL 6.50 %  	0 
COL Beer_Name VAL Imperial Moustache Red Ale COL Brew_Factory_Name VAL The Dodging Duck Brewhaus COL Style VAL American Amber / Red Ale COL ABV VAL -  	COL Beer_Name VAL Figueroa Mountain / Pizza Port Shark Lips Imperial Red Ale COL Brew_Factory_Name VAL Destihl Brewery COL Style VAL Barley Wine COL ABV VAL 9.30 %  	0 
COL Beer_Name VAL Winter Seasonal Amber Ale COL Brew_Factory_Name VAL Liquid Mechanics Brewing Co. . COL Style VAL American Amber / Red Ale COL ABV VAL 4.50 %  	COL Beer_Name VAL Swamp Head Sciaenhops Imperial Red Ale COL Brew_Factory_Name VAL Thirsty Pagan Brewing COL Style VAL Amber Ale COL ABV VAL -  	0 
COL Beer_Name VAL Jurassic Duck Amber Ale ( dry Hopped With Mosaic ) COL Brew_Factory_Name VAL Roaring Fork Beer Company COL Style VAL American Amber / Red Ale COL ABV VAL 9.50 %  	COL Beer_Name VAL Radiant Pig Gangster Duck American Red Ale COL Brew_Factory_Name VAL Wildcard Brewing Company COL Style VAL Barley Wine COL ABV VAL 6 %  	0 
COL Beer_Name VAL Mountian Goat Rare Breed India Red Ale COL Brew_Factory_Name VAL Elk Street Brewery & Tap Room COL Style VAL American Amber / Red Ale COL ABV VAL 6.80 %  	COL Beer_Name VAL Sick N Twisted Naughty Redhead Imperial Red Ale COL Brew_Factory_Name VAL The Beer Company COL Style VAL Irish Ale COL ABV VAL -  	0 
COL Beer_Name VAL Wasatch 50th Park City Golden Anniversary Ale COL Brew_Factory_Name VAL Pioneer Beer Company COL Style VAL American Amber / Red Ale COL ABV VAL -  	COL Beer_Name VAL Engine House No. 9 Rowdy Dick Amber Ale COL Brew_Factory_Name VAL Ballast Point Brewing Company COL Style VAL Amber Ale COL ABV VAL 6.50 %  	0 
COL Beer_Name VAL Vital Infrared Imperial Red COL Brew_Factory_Name VAL Vital Brewing COL Style VAL American Amber / Red Ale COL ABV VAL 9.40 %  	COL Beer_Name VAL Vital Infrared Imperial Red COL Brew_Factory_Name VAL Vital Brewing COL Style VAL American Strong Ale COL ABV VAL 9.40 %  	1 
COL Beer_Name VAL Pioneer American Red Ale COL Brew_Factory_Name VAL Bowen Island Brewing Co. Ltd. . COL Style VAL American Amber / Red Ale COL ABV VAL 8.60 %  	COL Beer_Name VAL Heavy Seas Desert Island Series American Honey Amber Ale COL Brew_Factory_Name VAL Out of Bounds Brewing Company COL Style VAL Barley Wine COL ABV VAL -  	0 
COL Beer_Name VAL Big Horn Buttface Amber Ale COL Brew_Factory_Name VAL OPA-OPA Steakhouse & Brewery COL Style VAL American Amber / Red Ale COL ABV VAL 6.20 %  	COL Beer_Name VAL Iron Horse Fresh Hop Imperial Red Ale COL Brew_Factory_Name VAL Canal Park Brewing Company COL Style VAL Amber Ale COL ABV VAL -  	0 
COL Beer_Name VAL All American Red Ale COL Brew_Factory_Name VAL Wild Ride Brewing Co. . COL Style VAL American Amber / Red Ale COL ABV VAL 6.00 %  	COL Beer_Name VAL Slanted Rock Iron Butt Red Ale COL Brew_Factory_Name VAL Saimaan Juomatehdas COL Style VAL Amber Ale COL ABV VAL -  	0 
COL Beer_Name VAL Vital Infrared Imperial Red COL Brew_Factory_Name VAL Vital Brewing COL Style VAL American Amber / Red Ale COL ABV VAL 9.40 %  	COL Beer_Name VAL Vital Infrared Imperial Red COL Brew_Factory_Name VAL Vital Brewing COL Style VAL American Strong Ale COL ABV VAL 9.40 %  	1 
COL Beer_Name VAL Red 88 Imperial Amber Ale COL Brew_Factory_Name VAL Olde Richmond Beer Company COL Style VAL American Amber / Red Ale COL ABV VAL -  	COL Beer_Name VAL Destihl Barrel Aged Deadhead Double Red Ale COL Brew_Factory_Name VAL Mad River Brewery COL Style VAL Amber Ale COL ABV VAL 5.50 %  	0 
COL Beer_Name VAL Vital Infrared Imperial Red COL Brew_Factory_Name VAL Vital Brewing COL Style VAL American Amber / Red Ale COL ABV VAL 9.40 %  	COL Beer_Name VAL Vital Infrared Imperial Red COL Brew_Factory_Name VAL Vital Brewing COL Style VAL American Strong Ale COL ABV VAL 9.40 %  	1 
COL Beer_Name VAL Rocky Mountain Red Ale COL Brew_Factory_Name VAL Indian Wells Brewing Company COL Style VAL American Amber / Red Ale COL ABV VAL 4.90 %  	COL Beer_Name VAL Squatters Respect Your Mother Organic Amber Ale COL Brew_Factory_Name VAL Central Coast Brewing COL Style VAL Amber Ale COL ABV VAL -  	0 
COL Beer_Name VAL Bourbon Barrel Red Oak Ale COL Brew_Factory_Name VAL Fish Rock Brewery COL Style VAL American Amber / Red Ale COL ABV VAL -  	COL Beer_Name VAL Bacchus / Burrow Bloodhound Blood Red IPA COL Brew_Factory_Name VAL Proof Brewing Company COL Style VAL Amber Ale COL ABV VAL 6.20 %  	0 
COL Beer_Name VAL Bourbon Barrel Ro Shampo Imperial Red Ale COL Brew_Factory_Name VAL Figure 8 Brewing COL Style VAL American Amber / Red Ale COL ABV VAL -  	COL Beer_Name VAL Big Choice Disconnected Red Ale COL Brew_Factory_Name VAL Fat Bottom Brewery COL Style VAL Amber Ale COL ABV VAL 6.50 %  	0 
COL Beer_Name VAL Harold The Red Ale COL Brew_Factory_Name VAL Aspetuck Brew Lab COL Style VAL American Amber / Red Ale COL ABV VAL 6.20 %  	COL Beer_Name VAL Wildcard Double Down Imperial Red Ale COL Brew_Factory_Name VAL Red Horn Coffee House and Brewing Company COL Style VAL Amber Ale COL ABV VAL 5 %  	0 
COL Beer_Name VAL Ruby River Ruby Red Ale COL Brew_Factory_Name VAL Centennial Beer Co. . COL Style VAL American Amber / Red Ale COL ABV VAL -  	COL Beer_Name VAL Ballast Point Calico Amber Ale - Rum Barrel Aged COL Brew_Factory_Name VAL Sick N Twisted Brewing Company COL Style VAL Amber Ale COL ABV VAL 8.60 %  	0 
COL Beer_Name VAL Starfish Imperial Red Ale COL Brew_Factory_Name VAL Port Brewing COL Style VAL American Amber / Red Ale COL ABV VAL 4.00 %  	COL Beer_Name VAL Figueroa Mountain / Pizza Port Shark Lips Imperial Red Ale COL Brew_Factory_Name VAL AleSmith Brewing Company COL Style VAL Barley Wine COL ABV VAL -  	0 
COL Beer_Name VAL Bulleit Bourbon Barrel Aged G'Knight COL Brew_Factory_Name VAL Oskar Blues Grill & Brew COL Style VAL American Amber / Red Ale COL ABV VAL 4.00 %  	COL Beer_Name VAL Lompoc Bourbon Barrel Aged Old Tavern Rat COL Brew_Factory_Name VAL Anderson Valley Brewing Company COL Style VAL Barley Wine COL ABV VAL 6 %  	0 
COL Beer_Name VAL Buffalo Trace Bourbon Barrel Aged Amber Ale COL Brew_Factory_Name VAL Stilt House Brewery COL Style VAL American Amber / Red Ale COL ABV VAL -  	COL Beer_Name VAL Engine House No. 9 Rowdy Dick Amber Ale COL Brew_Factory_Name VAL Blue Heron Brewpub COL Style VAL Amber Ale COL ABV VAL 6.50 %  	0 
COL Beer_Name VAL Dread Double Red Ale COL Brew_Factory_Name VAL Roosterfish Brewing Co. . COL Style VAL American Amber / Red Ale COL ABV VAL -  	COL Beer_Name VAL Aarhus Cains Triple A American Amber Ale COL Brew_Factory_Name VAL Anheuser-Busch InBev COL Style VAL Amber Ale COL ABV VAL 6.50 %  	0 
COL Beer_Name VAL Broadhead Bourbon Barrel Aged Red COL Brew_Factory_Name VAL Hoppy Brewing Co. . COL Style VAL American Amber / Red Ale COL ABV VAL -  	COL Beer_Name VAL Midnight Sun Unite Double Red Hot Ale &#40; 2015 &#41; COL Brew_Factory_Name VAL Stadin Panimo COL Style VAL Amber Ale COL ABV VAL 5.50 %  	0 
COL Beer_Name VAL Bulleit Bourbon Barrel Aged G'Knight COL Brew_Factory_Name VAL Oskar Blues Grill & Brew COL Style VAL American Barleywine COL ABV VAL 9.80 %  	COL Beer_Name VAL MadTree Bourbon Barrel Aged Happy Amber COL Brew_Factory_Name VAL MadTree Brewing Company COL Style VAL Amber Ale COL ABV VAL 6 %  	0 
COL Beer_Name VAL Vital Infrared Imperial Red COL Brew_Factory_Name VAL Vital Brewing COL Style VAL American Amber / Red Ale COL ABV VAL 9.40 %  	COL Beer_Name VAL Vital Infrared Imperial Red COL Brew_Factory_Name VAL Vital Brewing COL Style VAL American Strong Ale COL ABV VAL 9.40 %  	1 
COL Beer_Name VAL Noggin Floggin ( Bourbon Barrel Aged ) COL Brew_Factory_Name VAL Flying Goose Brew Pub & Grille COL Style VAL American Amber / Red Ale COL ABV VAL 7.00 %  	COL Beer_Name VAL AleSmith Old Numbskull - Bourbon Barrel Aged COL Brew_Factory_Name VAL AleSmith Brewing Company COL Style VAL Barley Wine COL ABV VAL 6 %  	0 
COL Beer_Name VAL Constanza _ ™ s Hoppy Red Ale COL Brew_Factory_Name VAL Grand Lake Brewing Company COL Style VAL American Amber / Red Ale COL ABV VAL 4.90 %  	COL Beer_Name VAL Granville Island Gastown Amber Ale COL Brew_Factory_Name VAL Hammond River Brewing COL Style VAL Amber Ale COL ABV VAL 6 %  	0 
COL Beer_Name VAL Vital Infrared Imperial Red COL Brew_Factory_Name VAL Vital Brewing COL Style VAL American Amber / Red Ale COL ABV VAL 9.40 %  	COL Beer_Name VAL Vital Infrared Imperial Red COL Brew_Factory_Name VAL Vital Brewing COL Style VAL American Strong Ale COL ABV VAL 9.40 %  	1 
COL Beer_Name VAL 6th Anniversary Ale ( Dirty Hippie Imperial Red Ale ) COL Brew_Factory_Name VAL Kern River Brewing Company COL Style VAL American Amber / Red Ale COL ABV VAL 8.00 %  	COL Beer_Name VAL Brew Bus Detour Series : Rollin Dirty Red Ale - Wood Aged COL Brew_Factory_Name VAL Cigar City Brewing COL Style VAL Irish Ale COL ABV VAL 5 %  	0 
COL Beer_Name VAL Vital Infrared Imperial Red COL Brew_Factory_Name VAL Vital Brewing COL Style VAL American Barleywine COL ABV VAL 9.40 %  	COL Beer_Name VAL Vital Infrared Imperial Red COL Brew_Factory_Name VAL Vital Brewing COL Style VAL American Strong Ale COL ABV VAL 9.40 %  	1 
COL Beer_Name VAL Mountain Series : Love Rhino ( Imperial Red Ale ) COL Brew_Factory_Name VAL Wig And Pen COL Style VAL American Amber / Red Ale COL ABV VAL 7.70 %  	COL Beer_Name VAL Hammond River Red Coat India Red Ale COL Brew_Factory_Name VAL Brewsters Brewing Co. - Alberta COL Style VAL Amber Ale COL ABV VAL 5 %  	0 
COL Beer_Name VAL Buffalo Trace Bourbon Barrel Aged Amber Ale COL Brew_Factory_Name VAL The Civil Life Brewing Company COL Style VAL American Amber / Red Ale COL ABV VAL -  	COL Beer_Name VAL Big Horn Buttface Amber Ale COL Brew_Factory_Name VAL Lompoc Brewing COL Style VAL Amber Ale COL ABV VAL 5.50 %  	0 
COL Beer_Name VAL Bulleit Bourbon Barrel Aged G'Knight COL Brew_Factory_Name VAL Oskar Blues Grill & Brew COL Style VAL American Amber / Red Ale COL ABV VAL 8.70 %  	COL Beer_Name VAL Lompoc Bourbon Barrel Aged Old Tavern Rat COL Brew_Factory_Name VAL Lompoc Brewing COL Style VAL Barley Wine COL ABV VAL 6 %  	0 
COL Beer_Name VAL Vital Infrared Imperial Red COL Brew_Factory_Name VAL Vital Brewing COL Style VAL American Amber / Red Ale COL ABV VAL 4.70 %  	COL Beer_Name VAL Vital Infrared Imperial Red COL Brew_Factory_Name VAL Vital Brewing COL Style VAL American Strong Ale COL ABV VAL 9.40 %  	1 
COL Beer_Name VAL Aorta Ale ( Double Red Ale ) COL Brew_Factory_Name VAL Mountain Goat Beer Pty Ltd COL Style VAL American Amber / Red Ale COL ABV VAL -  	COL Beer_Name VAL Wildcard Double Down Imperial Red Ale COL Brew_Factory_Name VAL Nighthawk Brewery COL Style VAL Amber Ale COL ABV VAL 8.30 %  	0 
COL Beer_Name VAL Isle Of Pines Barley Wine COL Brew_Factory_Name VAL The Civil Life Brewing Company COL Style VAL American Amber / Red Ale COL ABV VAL 7.00 %  	COL Beer_Name VAL Granville Island Gastown Amber Ale COL Brew_Factory_Name VAL Brewsters Brewing Co. - Alberta COL Style VAL Amber Ale COL ABV VAL 6 %  	0 
COL Beer_Name VAL Vital Infrared Imperial Red COL Brew_Factory_Name VAL Vital Brewing COL Style VAL American Amber / Red Ale COL ABV VAL 9.40 %  	COL Beer_Name VAL Vital Infrared Imperial Red COL Brew_Factory_Name VAL Vital Brewing COL Style VAL American Strong Ale COL ABV VAL 9.40 %  	1 
COL Beer_Name VAL Bourbon Barrel Aged Horus Imperial Red COL Brew_Factory_Name VAL Tornado Brewing Company COL Style VAL American Amber / Red Ale COL ABV VAL 5.40 %  	COL Beer_Name VAL Granville Island Gastown Amber Ale COL Brew_Factory_Name VAL Blue Pants Brewery COL Style VAL Amber Ale COL ABV VAL 8 %  	0 
COL Beer_Name VAL Vital Infrared Imperial Red COL Brew_Factory_Name VAL Vital Brewing COL Style VAL American Amber / Red Ale COL ABV VAL 9.40 %  	COL Beer_Name VAL Vital Infrared Imperial Red COL Brew_Factory_Name VAL Vital Brewing COL Style VAL American Strong Ale COL ABV VAL 9.40 %  	1 
COL Beer_Name VAL Fresh Hop Red COL Brew_Factory_Name VAL Wild Ride Brewing Co. . COL Style VAL American Amber / Red Ale COL ABV VAL 6.00 %  	COL Beer_Name VAL Nighthawk 16-Hour Dry Hopped Amber COL Brew_Factory_Name VAL Saimaan Juomatehdas COL Style VAL Amber Ale COL ABV VAL 8 %  	0 
COL Beer_Name VAL Noggin Floggin ( Bourbon Barrel Aged ) COL Brew_Factory_Name VAL Hopworks Urban Brewery COL Style VAL American Barleywine COL ABV VAL 7.00 %  	COL Beer_Name VAL Aspen Bourbon Barrel Aged Conundrum Red Ale COL Brew_Factory_Name VAL Proof Brewing Company COL Style VAL Amber Ale COL ABV VAL 6 %  	0 
COL Beer_Name VAL Vital Infrared Imperial Red COL Brew_Factory_Name VAL Vital Brewing COL Style VAL American Amber / Red Ale COL ABV VAL 9.40 %  	COL Beer_Name VAL Vital Infrared Imperial Red COL Brew_Factory_Name VAL Vital Brewing COL Style VAL American Strong Ale COL ABV VAL 9.40 %  	1 
COL Beer_Name VAL Vital Infrared Imperial Red COL Brew_Factory_Name VAL Vital Brewing COL Style VAL American Amber / Red Ale COL ABV VAL 9.40 %  	COL Beer_Name VAL Vital Infrared Imperial Red COL Brew_Factory_Name VAL Vital Brewing COL Style VAL American Strong Ale COL ABV VAL 9.40 %  	1 
COL Beer_Name VAL Buffalo Trace Bourbon Barrel Aged Amber Ale COL Brew_Factory_Name VAL Liquid Mechanics Brewing Co. . COL Style VAL American Amber / Red Ale COL ABV VAL -  	COL Beer_Name VAL Midnight Sun Unite Double Red Hot Ale &#40; 2015 &#41; COL Brew_Factory_Name VAL Stadin Panimo COL Style VAL Amber Ale COL ABV VAL 6.50 %  	0 
COL Beer_Name VAL Buffalo Trace Bourbon Barrel Aged Amber Ale COL Brew_Factory_Name VAL Third Base Sports Bar & Brewery COL Style VAL American Amber / Red Ale COL ABV VAL -  	COL Beer_Name VAL Red Duck Amber Ale COL Brew_Factory_Name VAL Purrumbete Brewing COL Style VAL Amber Ale COL ABV VAL 4.90 %  	0 
COL Beer_Name VAL Vital Infrared Imperial Red COL Brew_Factory_Name VAL Vital Brewing COL Style VAL American Amber / Red Ale COL ABV VAL 9.40 %  	COL Beer_Name VAL Vital Infrared Imperial Red COL Brew_Factory_Name VAL Vital Brewing COL Style VAL American Strong Ale COL ABV VAL 9.40 %  	1 
COL Beer_Name VAL Red Emperor Amber Ale COL Brew_Factory_Name VAL The Seven Barrel Brewery COL Style VAL American Amber / Red Ale COL ABV VAL 4.00 %  	COL Beer_Name VAL Thirsty Pagan North Coast Amber Ale COL Brew_Factory_Name VAL Legacy Brewing COL Style VAL Amber Ale COL ABV VAL 5 %  	0 
COL Beer_Name VAL Kniksen India Red Ale COL Brew_Factory_Name VAL 7 Fjell Bryggeri COL Style VAL American Amber / Red Ale COL ABV VAL 8.20 %  	COL Beer_Name VAL Americas American Red Ale COL Brew_Factory_Name VAL Good People Brewing Company COL Style VAL Irish Ale COL ABV VAL -  	0 
COL Beer_Name VAL Vital Infrared Imperial Red COL Brew_Factory_Name VAL Vital Brewing COL Style VAL American Amber / Red Ale COL ABV VAL 9.40 %  	COL Beer_Name VAL Vital Infrared Imperial Red COL Brew_Factory_Name VAL Vital Brewing COL Style VAL American Strong Ale COL ABV VAL 9.40 %  	1 
COL Beer_Name VAL Vital Infrared Imperial Red COL Brew_Factory_Name VAL Vital Brewing COL Style VAL American Amber / Red Ale COL ABV VAL 9.40 %  	COL Beer_Name VAL Vital Infrared Imperial Red COL Brew_Factory_Name VAL Vital Brewing COL Style VAL American Strong Ale COL ABV VAL 9.40 %  	1 
COL Beer_Name VAL Red 88 Imperial Amber Ale COL Brew_Factory_Name VAL Breckenridge Brewery COL Style VAL American Amber / Red Ale COL ABV VAL 7.00 %  	COL Beer_Name VAL Radiant Pig Gangster Duck American Red Ale COL Brew_Factory_Name VAL Golden City Brewery COL Style VAL Barley Wine COL ABV VAL 6 %  	0 
COL Beer_Name VAL Vital Infrared Imperial Red COL Brew_Factory_Name VAL Vital Brewing COL Style VAL American Amber / Red Ale COL ABV VAL 9.40 %  	COL Beer_Name VAL Vital Infrared Imperial Red COL Brew_Factory_Name VAL Vital Brewing COL Style VAL American Strong Ale COL ABV VAL 9.40 %  	1 
COL Beer_Name VAL Sequoia American Amber Ale COL Brew_Factory_Name VAL Heavy Seas Beer COL Style VAL American Amber / Red Ale COL ABV VAL 8.50 %  	COL Beer_Name VAL Charleville Tornado Alley Amber Ale COL Brew_Factory_Name VAL Squatters Craft Beers COL Style VAL Amber Ale COL ABV VAL -  	0 
COL Beer_Name VAL Bulleit Bourbon Barrel Aged G'Knight COL Brew_Factory_Name VAL Oskar Blues Grill & Brew COL Style VAL American Amber / Red Ale COL ABV VAL 8.70 %  	COL Beer_Name VAL Lompoc Bourbon Barrel Aged Old Tavern Rat COL Brew_Factory_Name VAL Lompoc Brewing COL Style VAL Barley Wine COL ABV VAL 6 %  	0 
COL Beer_Name VAL Clifford The Big Red Ale COL Brew_Factory_Name VAL New Helvetia Brewing Company COL Style VAL American Amber / Red Ale COL ABV VAL -  	COL Beer_Name VAL Flossmoor Station Barrel Aged Panama Limited Red Ale COL Brew_Factory_Name VAL Golden City Brewery COL Style VAL Amber Ale COL ABV VAL 6 %  	0 
COL Beer_Name VAL Red Shedman 's Imperial Amber Ale COL Brew_Factory_Name VAL Outpost Natural Foods COL Style VAL American Amber / Red Ale COL ABV VAL 5.20 %  	COL Beer_Name VAL Aarhus Cains Triple A American Amber Ale COL Brew_Factory_Name VAL Big Rock Brewery COL Style VAL Amber Ale COL ABV VAL -  	0 
COL Beer_Name VAL Vital Infrared Imperial Red COL Brew_Factory_Name VAL Vital Brewing COL Style VAL American Amber / Red Ale COL ABV VAL 9.40 %  	COL Beer_Name VAL Vital Infrared Imperial Red COL Brew_Factory_Name VAL Vital Brewing COL Style VAL American Strong Ale COL ABV VAL 9.40 %  	1 
COL Beer_Name VAL Molly American Red Ale COL Brew_Factory_Name VAL Twisted K-8 Brewing Company COL Style VAL American Amber / Red Ale COL ABV VAL 7.00 %  	COL Beer_Name VAL Bacchus / Burrow Bloodhound Blood Red IPA COL Brew_Factory_Name VAL Big Time Brewery COL Style VAL India Pale Ale &#40; IPA &#41; COL ABV VAL 6 %  	0 
COL Beer_Name VAL Old Cascade Amber Ale COL Brew_Factory_Name VAL Wellington County Brewery COL Style VAL American Barleywine COL ABV VAL 5.80 %  	COL Beer_Name VAL Railway City Iron Spike Amber Ale COL Brew_Factory_Name VAL Hangar 24 Craft Brewery COL Style VAL Amber Ale COL ABV VAL -  	0 
COL Beer_Name VAL Brewmaster 's Reserve Imperial Red Ale COL Brew_Factory_Name VAL Figure 8 Brewing COL Style VAL American Amber / Red Ale COL ABV VAL 5.45 %  	COL Beer_Name VAL Legacy Bourbon Barrel Hedonism Red COL Brew_Factory_Name VAL Nighthawk Brewery COL Style VAL Amber Ale COL ABV VAL 8 %  	0 
COL Beer_Name VAL Vital Infrared Imperial Red COL Brew_Factory_Name VAL Vital Brewing COL Style VAL American Amber / Red Ale COL ABV VAL 9.40 %  	COL Beer_Name VAL Vital Infrared Imperial Red COL Brew_Factory_Name VAL Vital Brewing COL Style VAL American Strong Ale COL ABV VAL 9.40 %  	1 
COL Beer_Name VAL Desert Island Series : American Honey Amber Ale COL Brew_Factory_Name VAL Ruby River Steakhouse & Brewery COL Style VAL American Amber / Red Ale COL ABV VAL 7.40 %  	COL Beer_Name VAL Fat Bottom Ruby Red American Ale COL Brew_Factory_Name VAL Anheuser-Busch InBev COL Style VAL Amber Ale COL ABV VAL -  	0 
COL Beer_Name VAL 6th Anniversary Ale ( Dirty Hippie Imperial Red Ale ) COL Brew_Factory_Name VAL Kern River Brewing Company COL Style VAL American Amber / Red Ale COL ABV VAL -  	COL Beer_Name VAL Brew Bus Detour Series : Rollin Dirty Red Ale - Wood Aged COL Brew_Factory_Name VAL Cigar City Brewing COL Style VAL Irish Ale COL ABV VAL 5 %  	0 
COL Beer_Name VAL Bulleit Bourbon Barrel Aged G'Knight COL Brew_Factory_Name VAL Hopworks Urban Brewery COL Style VAL American Amber / Red Ale COL ABV VAL 8.70 %  	COL Beer_Name VAL Lompoc Bourbon Barrel Aged Old Tavern Rat COL Brew_Factory_Name VAL Lompoc Brewing COL Style VAL Barley Wine COL ABV VAL 6 %  	0 
COL Beer_Name VAL Merry Prankster Imperial Red Ale COL Brew_Factory_Name VAL Titanic Brewery COL Style VAL American Amber / Red Ale COL ABV VAL 9.10 %  	COL Beer_Name VAL Red Horn Coffee House and Brewing Company Red Horn Drink Well Red Ale COL Brew_Factory_Name VAL Sick N Twisted Brewing Company COL Style VAL Amber Ale COL ABV VAL 8 %  	0 
COL Beer_Name VAL Big Bully Amber Ale COL Brew_Factory_Name VAL Books & Brews COL Style VAL American Amber / Red Ale COL ABV VAL 8.00 %  	COL Beer_Name VAL Ballast Point Calico Amber Ale - Rum Barrel Aged COL Brew_Factory_Name VAL Americas Brewpub COL Style VAL Amber Ale COL ABV VAL 5 %  	0 
COL Beer_Name VAL Ro Shampo Imperial Red Ale COL Brew_Factory_Name VAL Dead Frog Brewing COL Style VAL American Amber / Red Ale COL ABV VAL 5.60 %  	COL Beer_Name VAL Anderson Valley Barrel Aged Horn of the Beer Barley Wine COL Brew_Factory_Name VAL Fat Bottom Brewery COL Style VAL Amber Ale COL ABV VAL -  	0 
COL Beer_Name VAL Extra Special Red Ale COL Brew_Factory_Name VAL Wig And Pen COL Style VAL American Amber / Red Ale COL ABV VAL 7.00 %  	COL Beer_Name VAL Bacchus / Burrow Bloodhound Blood Red IPA COL Brew_Factory_Name VAL Boneyard Beer Company COL Style VAL India Pale Ale &#40; IPA &#41; COL ABV VAL 5 %  	0 
COL Beer_Name VAL Noggin Floggin ( Bourbon Barrel Aged ) COL Brew_Factory_Name VAL Hopworks Urban Brewery COL Style VAL American Barleywine COL ABV VAL 7.00 %  	COL Beer_Name VAL MadTree Bourbon Barrel Aged Happy Amber COL Brew_Factory_Name VAL MadTree Brewing Company COL Style VAL Amber Ale COL ABV VAL 6 %  	0 
COL Beer_Name VAL Fresh Hop Red COL Brew_Factory_Name VAL Beachwood BBQ & Brewing COL Style VAL American Amber / Red Ale COL ABV VAL -  	COL Beer_Name VAL Radiant Pig Gangster Duck American Red Ale COL Brew_Factory_Name VAL Midnight Sun Brewing Company COL Style VAL Barley Wine COL ABV VAL 5.30 %  	0 
COL Beer_Name VAL All American Red Ale COL Brew_Factory_Name VAL Big Axe Brewing Company COL Style VAL American Amber / Red Ale COL ABV VAL -  	COL Beer_Name VAL Flossmoor Station Barrel Aged Panama Limited Red Ale COL Brew_Factory_Name VAL Swamp Head Brewery COL Style VAL Amber Ale COL ABV VAL 7.50 %  	0 
COL Beer_Name VAL Isle Of Pines Barley Wine COL Brew_Factory_Name VAL Beachwood BBQ & Brewing COL Style VAL American Amber / Red Ale COL ABV VAL -  	COL Beer_Name VAL Boneyard Skunkape India Red Ale COL Brew_Factory_Name VAL Blue Heron Brewpub COL Style VAL Barley Wine COL ABV VAL 8.60 %  	0 
COL Beer_Name VAL Panama Limited Red Ale COL Brew_Factory_Name VAL Picaroons Brewing Co. . COL Style VAL American Amber / Red Ale COL ABV VAL 6.00 %  	COL Beer_Name VAL Slanted Rock Iron Butt Red Ale COL Brew_Factory_Name VAL Stadin Panimo COL Style VAL Amber Ale COL ABV VAL 5 %  	0 
COL Beer_Name VAL Shark Attack Double Red Ale COL Brew_Factory_Name VAL Utah Brewers Cooperative COL Style VAL American Amber / Red Ale COL ABV VAL -  	COL Beer_Name VAL Iron Horse Fresh Hop Imperial Red Ale COL Brew_Factory_Name VAL Austin Beerworks COL Style VAL Amber Ale COL ABV VAL 7.09 %  	0 
COL Beer_Name VAL Panama Limited Red Ale COL Brew_Factory_Name VAL Edge Brewing COL Style VAL American Amber / Red Ale COL ABV VAL 5.50 %  	COL Beer_Name VAL Hammond River Red Coat India Red Ale COL Brew_Factory_Name VAL Big Horn Brewing Company &#40; Ram International &#41; COL Style VAL Amber Ale COL ABV VAL -  	0 
COL Beer_Name VAL Constanza _ ™ s Hoppy Red Ale COL Brew_Factory_Name VAL Pizza Port Solana Beach COL Style VAL American Amber / Red Ale COL ABV VAL 6.50 %  	COL Beer_Name VAL Fat Bottom Ruby Red American Ale COL Brew_Factory_Name VAL Fat Bottom Brewery COL Style VAL Amber Ale COL ABV VAL -  	0 
COL Beer_Name VAL Starlord 's Mixtape / Groot Drank Imperial Red Ale COL Brew_Factory_Name VAL Stewart 's Brewing Co. . COL Style VAL American Amber / Red Ale COL ABV VAL 9.00 %  	COL Beer_Name VAL Mad River Jamaica Red Ale COL Brew_Factory_Name VAL Americas Brewpub COL Style VAL Amber Ale COL ABV VAL -  	0 
COL Beer_Name VAL Bulleit Bourbon Barrel Aged G'Knight COL Brew_Factory_Name VAL Oskar Blues Grill & Brew COL Style VAL American Amber / Red Ale COL ABV VAL 8.70 %  	COL Beer_Name VAL Lompoc Bourbon Barrel Aged Old Tavern Rat COL Brew_Factory_Name VAL Lompoc Brewing COL Style VAL Barley Wine COL ABV VAL 6 %  	0 
COL Beer_Name VAL Stone Liberty Station Outbreak Series : Red Ale COL Brew_Factory_Name VAL Midnight Sun Brewing Co. . COL Style VAL American Amber / Red Ale COL ABV VAL 5.00 %  	COL Beer_Name VAL Destihl Barrel Aged Deadhead Double Red Ale COL Brew_Factory_Name VAL Laguna Beach Brewing COL Style VAL India Pale Ale &#40; IPA &#41; COL ABV VAL -  	0 
COL Beer_Name VAL Hawai'i Nui Sunset Amber Ale COL Brew_Factory_Name VAL Port Brewing COL Style VAL American Amber / Red Ale COL ABV VAL -  	COL Beer_Name VAL Barrel Trolley Amber Ale COL Brew_Factory_Name VAL Engine House No. 9 Restaurant and Brewery COL Style VAL Amber Ale COL ABV VAL 7.09 %  	0 
COL Beer_Name VAL Big V Amber Ale COL Brew_Factory_Name VAL Mountain Goat Beer Pty Ltd COL Style VAL American Amber / Red Ale COL ABV VAL -  	COL Beer_Name VAL Destihl Barrel Aged Deadhead Double Red Ale COL Brew_Factory_Name VAL Kettle House Brewing Company COL Style VAL Amber Ale COL ABV VAL 5.50 %  	0 
COL Beer_Name VAL Vital Infrared Imperial Red COL Brew_Factory_Name VAL Vital Brewing COL Style VAL American Amber / Red Ale COL ABV VAL 9.40 %  	COL Beer_Name VAL Vital Infrared Imperial Red COL Brew_Factory_Name VAL Vital Brewing COL Style VAL American Strong Ale COL ABV VAL 9.40 %  	1 
COL Beer_Name VAL Kingpin Double Red Ale COL Brew_Factory_Name VAL Titanic Brewery COL Style VAL American Amber / Red Ale COL ABV VAL -  	COL Beer_Name VAL Barley_s Barrel Aged Ulysses Imperial Red Ale COL Brew_Factory_Name VAL Grand Canyon Brewing Company COL Style VAL Amber Ale COL ABV VAL 6.40 %  	0 
COL Beer_Name VAL Big Axe Red Ale COL Brew_Factory_Name VAL The Seven Barrel Brewery COL Style VAL American Amber / Red Ale COL ABV VAL 5.40 %  	COL Beer_Name VAL Canal Park General Sterling Price American Amber Ale - Centennial COL Brew_Factory_Name VAL William Street Beer Co. . COL Style VAL Amber Ale COL ABV VAL -  	0 
COL Beer_Name VAL Deputation Imperial Red Ale COL Brew_Factory_Name VAL Books & Brews COL Style VAL American Amber / Red Ale COL ABV VAL 4.50 %  	COL Beer_Name VAL Slanted Rock Iron Butt Red Ale COL Brew_Factory_Name VAL Grand Canyon Brewing Company COL Style VAL Amber Ale COL ABV VAL -  	0 
COL Beer_Name VAL Barrel Aged Riverside Red COL Brew_Factory_Name VAL Mountain Goat Beer Pty Ltd COL Style VAL American Amber / Red Ale COL ABV VAL -  	COL Beer_Name VAL Big Time Lift Ticket American Red Ale COL Brew_Factory_Name VAL Big Axe Brewery and B & B COL Style VAL Amber Ale COL ABV VAL 5.60 %  	0 
COL Beer_Name VAL Big Bear Amber Ale COL Brew_Factory_Name VAL Centennial Beer Co. . COL Style VAL American Amber / Red Ale COL ABV VAL 8.50 %  	COL Beer_Name VAL Off the Rail Raybuck Red Ale COL Brew_Factory_Name VAL Red Horn Coffee House and Brewing Company COL Style VAL Amber Ale COL ABV VAL -  	0 
COL Beer_Name VAL Ro Shampo Imperial Red Ale COL Brew_Factory_Name VAL Bomber Brewing COL Style VAL American Amber / Red Ale COL ABV VAL -  	COL Beer_Name VAL Squatters Respect Your Mother Organic Amber Ale COL Brew_Factory_Name VAL Austin Beerworks COL Style VAL Amber Ale COL ABV VAL 5.50 %  	0 
COL Beer_Name VAL Wasatch 50th Park City Golden Anniversary Ale COL Brew_Factory_Name VAL Liquid Mechanics Brewing Co. . COL Style VAL American Amber / Red Ale COL ABV VAL 8.20 %  	COL Beer_Name VAL Figueroa Mountain / Pizza Port Shark Lips Imperial Red Ale COL Brew_Factory_Name VAL Spring House Brewing Company COL Style VAL Barley Wine COL ABV VAL 5 %  	0 
COL Beer_Name VAL Red Emperor Amber Ale COL Brew_Factory_Name VAL Ruby River Steakhouse & Brewery COL Style VAL American Amber / Red Ale COL ABV VAL 5.20 %  	COL Beer_Name VAL Big Choice Disconnected Red Ale COL Brew_Factory_Name VAL Piney River Brewing Company COL Style VAL Amber Ale COL ABV VAL -  	0 
COL Beer_Name VAL Big Axe Red Ale COL Brew_Factory_Name VAL Port Brewing COL Style VAL American Amber / Red Ale COL ABV VAL 5.40 %  	COL Beer_Name VAL Oak Creek King Crimson Imperial Red Ale COL Brew_Factory_Name VAL Big Axe Brewery and B & B COL Style VAL Barley Wine COL ABV VAL 8 %  	0 
COL Beer_Name VAL O'Connor 's Irish Red Ale COL Brew_Factory_Name VAL Big Bay Brewing Co. . COL Style VAL American Amber / Red Ale COL ABV VAL -  	COL Beer_Name VAL Ice Harbor Double Red Ale - Fresh Hop COL Brew_Factory_Name VAL Ballast Point Brewing Company COL Style VAL Amber Ale COL ABV VAL 7.70 %  	0 
COL Beer_Name VAL Deputation Imperial Red Ale COL Brew_Factory_Name VAL Ruby River Steakhouse & Brewery COL Style VAL American Amber / Red Ale COL ABV VAL 4.50 %  	COL Beer_Name VAL Sick N Twisted Naughty Redhead Imperial Red Ale COL Brew_Factory_Name VAL Brewsters Brewing Co. - Alberta COL Style VAL Amber Ale COL ABV VAL 8 %  	0 
COL Beer_Name VAL 5 Star Amber Ale COL Brew_Factory_Name VAL Intuition Ale Works COL Style VAL American Amber / Red Ale COL ABV VAL 4.00 %  	COL Beer_Name VAL Lavery Imperial Red Ale &#40; IRA &#41; COL Brew_Factory_Name VAL Charleville Vineyard & Microbrewery COL Style VAL Amber Ale COL ABV VAL -  	0 
COL Beer_Name VAL All American Red Ale COL Brew_Factory_Name VAL Outpost Natural Foods COL Style VAL American Amber / Red Ale COL ABV VAL 5.90 %  	COL Beer_Name VAL Sick N Twisted Naughty Redhead Imperial Red Ale COL Brew_Factory_Name VAL Hill Farmstead Brewery COL Style VAL Amber Ale COL ABV VAL 8 %  	0 
COL Beer_Name VAL Sequoia American Amber Ale COL Brew_Factory_Name VAL New Helvetia Brewing Company COL Style VAL American Amber / Red Ale COL ABV VAL 7.40 %  	COL Beer_Name VAL Hammond River Red Coat India Red Ale COL Brew_Factory_Name VAL Faustino Microcervejeira COL Style VAL Amber Ale COL ABV VAL -  	0 
COL Beer_Name VAL Bourbon Barrel Aged Redrum COL Brew_Factory_Name VAL Bullfrog Brewery COL Style VAL American Amber / Red Ale COL ABV VAL 5.50 %  	COL Beer_Name VAL Iron Horse Fresh Hop Imperial Red Ale COL Brew_Factory_Name VAL Thirsty Pagan Brewing COL Style VAL Amber Ale COL ABV VAL 6 %  	0 
COL Beer_Name VAL Noggin Floggin ( Bourbon Barrel Aged ) COL Brew_Factory_Name VAL Hopworks Urban Brewery COL Style VAL American Barleywine COL ABV VAL 8.70 %  	COL Beer_Name VAL MadTree Bourbon Barrel Aged Happy Amber COL Brew_Factory_Name VAL MadTree Brewing Company COL Style VAL Amber Ale COL ABV VAL 6 %  	0 
COL Beer_Name VAL Sea Spray Amber Ale COL Brew_Factory_Name VAL Ruby River Steakhouse & Brewery COL Style VAL American Amber / Red Ale COL ABV VAL 4.90 %  	COL Beer_Name VAL Big Texan Texas Red Amber Ale COL Brew_Factory_Name VAL Charleville Vineyard & Microbrewery COL Style VAL Amber Ale COL ABV VAL 5 %  	0 
COL Beer_Name VAL Red Hopper ( Imperial Red Ale ) COL Brew_Factory_Name VAL Coronado Brewing Company COL Style VAL American Amber / Red Ale COL ABV VAL -  	COL Beer_Name VAL Heinzelmannchen Big Amber Gnome Ale COL Brew_Factory_Name VAL Granville Island &#40; Brewery - MolsonCoors &#41; COL Style VAL Amber Ale COL ABV VAL 6.50 %  	0 
COL Beer_Name VAL Stupiphany Imperial Red Ale COL Brew_Factory_Name VAL Centennial Beer Co. . COL Style VAL American Amber / Red Ale COL ABV VAL 6.80 %  	COL Beer_Name VAL Heavy Seas Desert Island Series American Honey Amber Ale COL Brew_Factory_Name VAL Ecliptic Brewing COL Style VAL Amber Ale COL ABV VAL -  	0 
COL Beer_Name VAL Stone Liberty Station Outbreak Series : Red Ale COL Brew_Factory_Name VAL Petoskey Brewing Company COL Style VAL American Amber / Red Ale COL ABV VAL 6.50 %  	COL Beer_Name VAL Speakeasy Wet Hop Prohibition Red Ale COL Brew_Factory_Name VAL Hammond River Brewing COL Style VAL Amber Ale COL ABV VAL -  	0 
COL Beer_Name VAL Big V Amber Ale COL Brew_Factory_Name VAL FreeWheel Brewing Company COL Style VAL American Amber / Red Ale COL ABV VAL 4.00 %  	COL Beer_Name VAL Aspen Bourbon Barrel Aged Conundrum Red Ale COL Brew_Factory_Name VAL Big Texan Brewery COL Style VAL Amber Ale COL ABV VAL 5 %  	0 
COL Beer_Name VAL All American Red Ale COL Brew_Factory_Name VAL Hoppy Brewing Co. . COL Style VAL American Amber / Red Ale COL ABV VAL -  	COL Beer_Name VAL Sick N Twisted Naughty Redhead Imperial Red Ale COL Brew_Factory_Name VAL Railway City Brewing Company COL Style VAL Barley Wine COL ABV VAL 6.50 %  	0 
COL Beer_Name VAL Hawai'i Nui Sunset Amber Ale COL Brew_Factory_Name VAL Flying Goose Brew Pub & Grille COL Style VAL American Amber / Red Ale COL ABV VAL 7.40 %  	COL Beer_Name VAL Swamp Head Sciaenhops Imperial Red Ale COL Brew_Factory_Name VAL Legacy Brewing COL Style VAL Barley Wine COL ABV VAL -  	0 
COL Beer_Name VAL Dread Double Red Ale COL Brew_Factory_Name VAL Figure 8 Brewing COL Style VAL American Amber / Red Ale COL ABV VAL -  	COL Beer_Name VAL Laurelwood Organic Deranger Imperial Red Ale COL Brew_Factory_Name VAL Golden City Brewery COL Style VAL Barley Wine COL ABV VAL 10 %  	0 
COL Beer_Name VAL Red Rose Amber Ale COL Brew_Factory_Name VAL Heavy Seas Beer COL Style VAL American Amber / Red Ale COL ABV VAL -  	COL Beer_Name VAL Big Choice Disconnected Red Ale COL Brew_Factory_Name VAL Pokertree COL Style VAL Amber Ale COL ABV VAL 5 %  	0 
COL Beer_Name VAL Red Rock Amber Ale COL Brew_Factory_Name VAL Bomber Brewing COL Style VAL American Amber / Red Ale COL ABV VAL -  	COL Beer_Name VAL Maldita Old Continent American Amber Ale COL Brew_Factory_Name VAL Pokertree COL Style VAL Amber Ale COL ABV VAL 6.50 %  	0 
COL Beer_Name VAL Noggin Floggin ( Bourbon Barrel Aged ) COL Brew_Factory_Name VAL Backpocket Brewing COL Style VAL American Amber / Red Ale COL ABV VAL 7.00 %  	COL Beer_Name VAL Bacchus / Burrow Bloodhound Blood Red IPA COL Brew_Factory_Name VAL Bacchus Brewing Company &#40; Australia &#41; COL Style VAL India Pale Ale &#40; IPA &#41; COL ABV VAL 6 %  	0 
COL Beer_Name VAL Ro Shampo Imperial Red Ale COL Brew_Factory_Name VAL Stilt House Brewery COL Style VAL American Amber / Red Ale COL ABV VAL 8.20 %  	COL Beer_Name VAL Granville Island Gastown Amber Ale COL Brew_Factory_Name VAL MadTree Brewing Company COL Style VAL Amber Ale COL ABV VAL -  	0 
COL Beer_Name VAL Ruby River Ruby Red Ale COL Brew_Factory_Name VAL Brannon 's Pub and Brewery COL Style VAL American Amber / Red Ale COL ABV VAL 4.50 %  	COL Beer_Name VAL Big Choice Disconnected Red Ale COL Brew_Factory_Name VAL Kilted Dragon Brewing Company COL Style VAL Amber Ale COL ABV VAL -  	0 
COL Beer_Name VAL Tongue Buckler - Imperial Red Ale COL Brew_Factory_Name VAL Black Husky Brewing COL Style VAL American Amber / Red Ale COL ABV VAL -  	COL Beer_Name VAL Railway City Iron Spike Amber Ale COL Brew_Factory_Name VAL Aarhus Bryghus COL Style VAL Amber Ale COL ABV VAL 6.70 %  	0 
COL Beer_Name VAL Stupiphany Imperial Red Ale COL Brew_Factory_Name VAL Picaroons Brewing Co. . COL Style VAL American Amber / Red Ale COL ABV VAL 11.00 %  	COL Beer_Name VAL Granville Island Gastown Amber Ale COL Brew_Factory_Name VAL Aspen Brewing Company COL Style VAL Amber Ale COL ABV VAL -  	0 
COL Beer_Name VAL Weekender American Amber Ale COL Brew_Factory_Name VAL Mountain Goat Beer Pty Ltd COL Style VAL American Amber / Red Ale COL ABV VAL 4.00 %  	COL Beer_Name VAL Lagunitas Imperial Red Ale COL Brew_Factory_Name VAL Liberty Brewery & Grill - High Point COL Style VAL Amber Ale COL ABV VAL 5 %  	0 
COL Beer_Name VAL O'Connor 's Irish Red Ale COL Brew_Factory_Name VAL Wormtown Brewery COL Style VAL American Amber / Red Ale COL ABV VAL 5.00 %  	COL Beer_Name VAL Loose Shoe SlÃ ¡ inte Irish Red Ale COL Brew_Factory_Name VAL The Beer Company COL Style VAL Irish Ale COL ABV VAL 7 %  	0 
COL Beer_Name VAL Ro Shampo Imperial Red Ale COL Brew_Factory_Name VAL Barley 's Brewing Company COL Style VAL American Amber / Red Ale COL ABV VAL 7.50 %  	COL Beer_Name VAL Elevator Barrel Aged Barley Wine COL Brew_Factory_Name VAL Mad River Brewery COL Style VAL Barley Wine COL ABV VAL -  	0 
COL Beer_Name VAL Ruby River Ruby Red Ale COL Brew_Factory_Name VAL Centennial Beer Co. . COL Style VAL American Amber / Red Ale COL ABV VAL 9.10 %  	COL Beer_Name VAL Big Texan Texas Red Amber Ale COL Brew_Factory_Name VAL Big Horn Brewing Company &#40; Ram International &#41; COL Style VAL Amber Ale COL ABV VAL -  	0 
COL Beer_Name VAL Harold The Red Ale COL Brew_Factory_Name VAL Stewart 's Brewing Co. . COL Style VAL American Amber / Red Ale COL ABV VAL -  	COL Beer_Name VAL Lompoc Bourbon Barrel Aged Old Tavern Rat COL Brew_Factory_Name VAL Loose Shoe Brewing Company COL Style VAL Amber Ale COL ABV VAL 4.60 %  	0 
COL Beer_Name VAL Barrel Aged Red Ale COL Brew_Factory_Name VAL Fish Rock Brewery COL Style VAL American Amber / Red Ale COL ABV VAL 9.00 %  	COL Beer_Name VAL Anderson Valley Barrel Aged Horn of the Beer Barley Wine COL Brew_Factory_Name VAL Iron Horse Brewery COL Style VAL Barley Wine COL ABV VAL 11 %  	0 
COL Beer_Name VAL Panama Limited Red Ale COL Brew_Factory_Name VAL Ruby River Steakhouse & Brewery COL Style VAL American Amber / Red Ale COL ABV VAL 4.90 %  	COL Beer_Name VAL Mad River Jamaica Red Ale COL Brew_Factory_Name VAL Big Rock Brewery COL Style VAL Amber Ale COL ABV VAL 5 %  	0 
COL Beer_Name VAL Vital Infrared Imperial Red COL Brew_Factory_Name VAL Vital Brewing COL Style VAL American Amber / Red Ale COL ABV VAL 9.40 %  	COL Beer_Name VAL Vital Infrared Imperial Red COL Brew_Factory_Name VAL Vital Brewing COL Style VAL American Strong Ale COL ABV VAL 9.40 %  	1 
COL Beer_Name VAL Ruby River Ruby Red Ale COL Brew_Factory_Name VAL Ruby River Steakhouse & Brewery COL Style VAL American Amber / Red Ale COL ABV VAL 4.00 %  	COL Beer_Name VAL Americas American Red Ale COL Brew_Factory_Name VAL Canal Park Brewing Company COL Style VAL Amber Ale COL ABV VAL 5 %  	0 
COL Beer_Name VAL The `` Ginger '' A Red Ale COL Brew_Factory_Name VAL Ale-Mania COL Style VAL American Amber / Red Ale COL ABV VAL 5.00 %  	COL Beer_Name VAL The Beer Company Wyatt Earp Red Ale COL Brew_Factory_Name VAL The Beer Company COL Style VAL Irish Ale COL ABV VAL 7 %  	0 
COL Beer_Name VAL Hawai'i Nui Sunset Amber Ale COL Brew_Factory_Name VAL Flossmoor Station Restaurant & Brewery COL Style VAL American Amber / Red Ale COL ABV VAL -  	COL Beer_Name VAL Squatters Respect Your Mother Organic Amber Ale COL Brew_Factory_Name VAL Anheuser-Busch InBev COL Style VAL Amber Ale COL ABV VAL 7.50 %  	0 
COL Beer_Name VAL Ruby River Ruby Red Ale COL Brew_Factory_Name VAL Redwood Lodge COL Style VAL American Amber / Red Ale COL ABV VAL 5.45 %  	COL Beer_Name VAL Squatters Respect Your Mother Organic Amber Ale COL Brew_Factory_Name VAL Flat 12 Bierwerks COL Style VAL Amber Ale COL ABV VAL -  	0 
COL Beer_Name VAL Big Horn Buttface Amber Ale COL Brew_Factory_Name VAL Stilt House Brewery COL Style VAL American Amber / Red Ale COL ABV VAL 6.00 %  	COL Beer_Name VAL Stadin American Red Ale COL Brew_Factory_Name VAL Saimaan Juomatehdas COL Style VAL Amber Ale COL ABV VAL 8 %  	0 
COL Beer_Name VAL Hawai'i Nui Sunset Amber Ale COL Brew_Factory_Name VAL Heavy Seas Beer COL Style VAL American Amber / Red Ale COL ABV VAL -  	COL Beer_Name VAL Ice Harbor Double Red Ale - Fresh Hop COL Brew_Factory_Name VAL Off the Rail Brewing COL Style VAL Amber Ale COL ABV VAL 6.60 %  	0 
COL Beer_Name VAL Vital Infrared Imperial Red COL Brew_Factory_Name VAL Vital Brewing COL Style VAL American Amber / Red Ale COL ABV VAL 9.40 %  	COL Beer_Name VAL Vital Infrared Imperial Red COL Brew_Factory_Name VAL Vital Brewing COL Style VAL American Strong Ale COL ABV VAL 9.40 %  	1 
COL Beer_Name VAL Shark Attack Double Red Ale COL Brew_Factory_Name VAL Ruby River Steakhouse & Brewery COL Style VAL American Amber / Red Ale COL ABV VAL 6.60 %  	COL Beer_Name VAL Sick N Twisted Naughty Redhead Imperial Red Ale COL Brew_Factory_Name VAL Elevator Brewing Company COL Style VAL Amber Ale COL ABV VAL 5 %  	0 
COL Beer_Name VAL North 45 Amber Ale COL Brew_Factory_Name VAL Baird Brewing Company / Fishmarket Taproom COL Style VAL American Amber / Red Ale COL ABV VAL -  	COL Beer_Name VAL Fox and Hound Red Fox Amber Ale COL Brew_Factory_Name VAL Brouwerij De Koninck &#40; Duvel-Moortgat &#41; COL Style VAL Amber Ale COL ABV VAL 5.50 %  	0 
COL Beer_Name VAL Big V Amber Ale COL Brew_Factory_Name VAL FreeWheel Brewing Company COL Style VAL American Amber / Red Ale COL ABV VAL 4.00 %  	COL Beer_Name VAL Golden City Centurion Barleywine Ale COL Brew_Factory_Name VAL Big Texan Brewery COL Style VAL Amber Ale COL ABV VAL 5 %  	0 
COL Beer_Name VAL Barrel Aged Riverside Red COL Brew_Factory_Name VAL Hawai'i Nui Brewing / Mehana Brewing Company COL Style VAL American Amber / Red Ale COL ABV VAL 5.50 %  	COL Beer_Name VAL Hammond River Red Coat India Red Ale COL Brew_Factory_Name VAL Swashbuckler Brewing Company COL Style VAL Amber Ale COL ABV VAL 6 %  	0 
COL Beer_Name VAL Buffalo Trace Bourbon Barrel Aged Amber Ale COL Brew_Factory_Name VAL Utah Brewers Cooperative COL Style VAL American Amber / Red Ale COL ABV VAL 8.00 %  	COL Beer_Name VAL Brew Bus Detour Series : Rollin Dirty Red Ale - Wood Aged COL Brew_Factory_Name VAL Cigar City Brewing COL Style VAL Irish Ale COL ABV VAL 5 %  	0 
COL Beer_Name VAL Bourbon Barrel Ro Shampo Imperial Red Ale COL Brew_Factory_Name VAL Port Brewing COL Style VAL American Amber / Red Ale COL ABV VAL 4.50 %  	COL Beer_Name VAL Yukon You Only Live Once Imperial Red Ale COL Brew_Factory_Name VAL Americas Brewpub COL Style VAL Amber Ale COL ABV VAL -  	0 
COL Beer_Name VAL Desert Island Series : American Honey Amber Ale COL Brew_Factory_Name VAL Bainbridge Island Brewing Company COL Style VAL American Amber / Red Ale COL ABV VAL 5.00 %  	COL Beer_Name VAL Ice Harbor Double Red Ale - Fresh Hop COL Brew_Factory_Name VAL Flossmoor Station Restaurant & Brewery COL Style VAL Amber Ale COL ABV VAL -  	0 
COL Beer_Name VAL Big Horn Buttface Amber Ale COL Brew_Factory_Name VAL Stilt House Brewery COL Style VAL American Amber / Red Ale COL ABV VAL 6.00 %  	COL Beer_Name VAL Destihl Barrel Aged Deadhead Double Red Ale COL Brew_Factory_Name VAL Saimaan Juomatehdas COL Style VAL Amber Ale COL ABV VAL 8 %  	0 
COL Beer_Name VAL Vital Infrared Imperial Red COL Brew_Factory_Name VAL Vital Brewing COL Style VAL American Amber / Red Ale COL ABV VAL 9.40 %  	COL Beer_Name VAL Vital Infrared Imperial Red COL Brew_Factory_Name VAL Vital Brewing COL Style VAL American Strong Ale COL ABV VAL 9.40 %  	1 
COL Beer_Name VAL Bulleit Bourbon Barrel Aged G'Knight COL Brew_Factory_Name VAL Backpocket Brewing COL Style VAL American Amber / Red Ale COL ABV VAL 11.00 %  	COL Beer_Name VAL MadTree Bourbon Barrel Aged Happy Amber COL Brew_Factory_Name VAL MadTree Brewing Company COL Style VAL Amber Ale COL ABV VAL 6 %  	0 
COL Beer_Name VAL Mountain Series : Love Rhino ( Imperial Red Ale ) COL Brew_Factory_Name VAL Baird Brewing Company / Fishmarket Taproom COL Style VAL American Amber / Red Ale COL ABV VAL 7.40 %  	COL Beer_Name VAL Imperial Oak Barrel Aged Odin_s Beard COL Brew_Factory_Name VAL Marble Brewery COL Style VAL Barley Wine COL ABV VAL 9 %  	0 
COL Beer_Name VAL 5 Star Amber Ale COL Brew_Factory_Name VAL Coronado Brewing Company COL Style VAL American Amber / Red Ale COL ABV VAL 4.50 %  	COL Beer_Name VAL Black Shirt American India Red Ale COL Brew_Factory_Name VAL Aarhus Bryghus COL Style VAL Amber Ale COL ABV VAL -  	0 
COL Beer_Name VAL All American Red Ale COL Brew_Factory_Name VAL Ruby River Steakhouse & Brewery COL Style VAL American Amber / Red Ale COL ABV VAL 5.00 %  	COL Beer_Name VAL Ballast Point Calico Amber Ale - Rum Barrel Aged COL Brew_Factory_Name VAL Proof Brewing Company COL Style VAL Amber Ale COL ABV VAL 8 %  	0 
COL Beer_Name VAL Mr. Grain Jeans Organic Amber Ale COL Brew_Factory_Name VAL Black Husky Brewing COL Style VAL American Amber / Red Ale COL ABV VAL -  	COL Beer_Name VAL Spiteful Angry Adam Hoppy Red Ale COL Brew_Factory_Name VAL Big Choice Brewing COL Style VAL Amber Ale COL ABV VAL 6 %  	0 
COL Beer_Name VAL Molly American Red Ale COL Brew_Factory_Name VAL Backpocket Brewing COL Style VAL American Amber / Red Ale COL ABV VAL 7.00 %  	COL Beer_Name VAL Bacchus / Burrow Bloodhound Blood Red IPA COL Brew_Factory_Name VAL Big Time Brewery COL Style VAL India Pale Ale &#40; IPA &#41; COL ABV VAL 6 %  	0 
COL Beer_Name VAL Vital Infrared Imperial Red COL Brew_Factory_Name VAL Vital Brewing COL Style VAL American Amber / Red Ale COL ABV VAL 9.40 %  	COL Beer_Name VAL Vital Infrared Imperial Red COL Brew_Factory_Name VAL Vital Brewing COL Style VAL American Strong Ale COL ABV VAL 9.40 %  	1 
COL Beer_Name VAL Olde Richmond Batch No. 9 Red Ale COL Brew_Factory_Name VAL Centennial Beer Co. . COL Style VAL American Amber / Red Ale COL ABV VAL 7.40 %  	COL Beer_Name VAL Aarhus Cains Triple A American Amber Ale COL Brew_Factory_Name VAL Canal Park Brewing Company COL Style VAL Amber Ale COL ABV VAL 5 %  	0 
COL Beer_Name VAL Vital Infrared Imperial Red COL Brew_Factory_Name VAL Vital Brewing COL Style VAL American Amber / Red Ale COL ABV VAL 9.40 %  	COL Beer_Name VAL Vital Infrared Imperial Red COL Brew_Factory_Name VAL Vital Brewing COL Style VAL American Strong Ale COL ABV VAL 9.40 %  	1 
COL Beer_Name VAL Vital Infrared Imperial Red COL Brew_Factory_Name VAL Vital Brewing COL Style VAL American Amber / Red Ale COL ABV VAL 9.40 %  	COL Beer_Name VAL Vital Infrared Imperial Red COL Brew_Factory_Name VAL Vital Brewing COL Style VAL American Strong Ale COL ABV VAL 9.40 %  	1 
COL Beer_Name VAL Hop Around Imperial Red Ale COL Brew_Factory_Name VAL Brannon 's Pub and Brewery COL Style VAL American Amber / Red Ale COL ABV VAL 13.00 %  	COL Beer_Name VAL Ice Harbor Double Red Ale - Fresh Hop COL Brew_Factory_Name VAL Imperial Oak Brewing COL Style VAL Amber Ale COL ABV VAL 8 %  	0 
COL Beer_Name VAL Mermaid 's Red Ale - Bourbon Oak Aged COL Brew_Factory_Name VAL Olde Richmond Beer Company COL Style VAL American Amber / Red Ale COL ABV VAL 4.00 %  	COL Beer_Name VAL Boxing Cat Firecracker Imperial Red Ale COL Brew_Factory_Name VAL Wynwood Brewing Company COL Style VAL Amber Ale COL ABV VAL 5 %  	0 
COL Beer_Name VAL Weekender American Amber Ale COL Brew_Factory_Name VAL Flying Goose Brew Pub & Grille COL Style VAL American Amber / Red Ale COL ABV VAL -  	COL Beer_Name VAL Flossmoor Station Barrel Aged Panama Limited Red Ale COL Brew_Factory_Name VAL Wild Ride Brewing COL Style VAL Amber Ale COL ABV VAL 6 %  	0 
COL Beer_Name VAL Barrel Aged Red Ale COL Brew_Factory_Name VAL Figure 8 Brewing COL Style VAL American Amber / Red Ale COL ABV VAL 6.80 %  	COL Beer_Name VAL Ballast Point Calico Amber Ale - Rum Barrel Aged COL Brew_Factory_Name VAL Genesee Brewing Company &#40; North American Breweries &#41; COL Style VAL Amber Ale COL ABV VAL 5 %  	0 
COL Beer_Name VAL Sea Spray Amber Ale COL Brew_Factory_Name VAL Indian Wells Brewing Company COL Style VAL American Amber / Red Ale COL ABV VAL 5.00 %  	COL Beer_Name VAL Canal Park General Sterling Price American Amber Ale - Centennial COL Brew_Factory_Name VAL Lompoc Brewing COL Style VAL Amber Ale COL ABV VAL -  	0 
COL Beer_Name VAL Road Rash Red COL Brew_Factory_Name VAL Centennial Beer Co. . COL Style VAL American Amber / Red Ale COL ABV VAL 4.00 %  	COL Beer_Name VAL Ice Harbor Double Red Ale - Fresh Hop COL Brew_Factory_Name VAL Custom Brewcrafters COL Style VAL Amber Ale COL ABV VAL 5 %  	0 
COL Beer_Name VAL Barrel Aged Red Ale COL Brew_Factory_Name VAL Big Axe Brewing Company COL Style VAL American Amber / Red Ale COL ABV VAL -  	COL Beer_Name VAL Iron Horse Fresh Hop Imperial Red Ale COL Brew_Factory_Name VAL Liberty Brewery & Grill - High Point COL Style VAL Barley Wine COL ABV VAL 9 %  	0 
COL Beer_Name VAL Vital Infrared Imperial Red COL Brew_Factory_Name VAL Vital Brewing COL Style VAL American Amber / Red Ale COL ABV VAL 9.40 %  	COL Beer_Name VAL Vital Infrared Imperial Red COL Brew_Factory_Name VAL Vital Brewing COL Style VAL American Strong Ale COL ABV VAL 9.40 %  	1 
COL Beer_Name VAL Red Emperor Amber Ale COL Brew_Factory_Name VAL Wig And Pen COL Style VAL American Amber / Red Ale COL ABV VAL -  	COL Beer_Name VAL Blue Heron Corey_s American Pale Ale &#40; C.A.P.A. &#41; COL Brew_Factory_Name VAL The Beer Company COL Style VAL Amber Ale COL ABV VAL 6.50 %  	0 
COL Beer_Name VAL Weekender American Amber Ale COL Brew_Factory_Name VAL Greenpoint Beerworks / Kelso of Brooklyn COL Style VAL American Amber / Red Ale COL ABV VAL 7.75 %  	COL Beer_Name VAL Spiteful Angry Adam Hoppy Red Ale COL Brew_Factory_Name VAL Midnight Sun Brewing Company COL Style VAL Amber Ale COL ABV VAL 5.10 %  	0 
COL Beer_Name VAL Alaskan Imperial Red Ale ( Pilot Series ) COL Brew_Factory_Name VAL Great Lakes Brewing Co. . COL Style VAL American Amber / Red Ale COL ABV VAL 7.00 %  	COL Beer_Name VAL Brewsters Winter WARMer Amber Ale COL Brew_Factory_Name VAL Purrumbete Brewing COL Style VAL Amber Ale COL ABV VAL 6 %  	0 
COL Beer_Name VAL Mr. Grain Jeans Organic Amber Ale COL Brew_Factory_Name VAL Abita Brewing Co. . COL Style VAL American Amber / Red Ale COL ABV VAL -  	COL Beer_Name VAL Boxing Cat Firecracker Imperial Red Ale COL Brew_Factory_Name VAL Americas Brewpub COL Style VAL Amber Ale COL ABV VAL 6 %  	0 
COL Beer_Name VAL Vital Infrared Imperial Red COL Brew_Factory_Name VAL Vital Brewing COL Style VAL American Amber / Red Ale COL ABV VAL 9.40 %  	COL Beer_Name VAL Vital Infrared Imperial Red COL Brew_Factory_Name VAL Vital Brewing COL Style VAL American Strong Ale COL ABV VAL 9.40 %  	1 
COL Beer_Name VAL 6th Anniversary Ale ( Dirty Hippie Imperial Red Ale ) COL Brew_Factory_Name VAL Kern River Brewing Company COL Style VAL American Amber / Red Ale COL ABV VAL -  	COL Beer_Name VAL Brew Bus Detour Series : Rollin Dirty Red Ale - Wood Aged COL Brew_Factory_Name VAL Cigar City Brewing COL Style VAL Irish Ale COL ABV VAL 5 %  	0 
COL Beer_Name VAL Vital Infrared Imperial Red COL Brew_Factory_Name VAL Vital Brewing COL Style VAL American Amber / Red Ale COL ABV VAL 9.40 %  	COL Beer_Name VAL Vital Infrared Imperial Red COL Brew_Factory_Name VAL Vital Brewing COL Style VAL American Strong Ale COL ABV VAL 9.40 %  	1 
COL Beer_Name VAL All American Red Ale COL Brew_Factory_Name VAL Aspetuck Brew Lab COL Style VAL American Amber / Red Ale COL ABV VAL 5.40 %  	COL Beer_Name VAL Two Brothers Revelry Imperial Red Ale COL Brew_Factory_Name VAL Kilted Dragon Brewing Company COL Style VAL Amber Ale COL ABV VAL -  	0 
COL Beer_Name VAL Stupiphany Imperial Red Ale COL Brew_Factory_Name VAL Ruby River Steakhouse & Brewery COL Style VAL American Amber / Red Ale COL ABV VAL 4.00 %  	COL Beer_Name VAL Canal Park General Sterling Price American Amber Ale - Centennial COL Brew_Factory_Name VAL Laurelwood Public House & Brewery COL Style VAL Amber Ale COL ABV VAL 5 %  	0 
COL Beer_Name VAL Vital Infrared Imperial Red COL Brew_Factory_Name VAL Vital Brewing COL Style VAL American Amber / Red Ale COL ABV VAL 9.40 %  	COL Beer_Name VAL Vital Infrared Imperial Red COL Brew_Factory_Name VAL Vital Brewing COL Style VAL American Strong Ale COL ABV VAL 9.40 %  	1 
COL Beer_Name VAL Frog Island Amber Ale COL Brew_Factory_Name VAL Rock Bottom Restaurant & Brewery COL Style VAL American Amber / Red Ale COL ABV VAL 4.50 %  	COL Beer_Name VAL Barrel Trolley Amber Ale COL Brew_Factory_Name VAL AleSmith Brewing Company COL Style VAL Amber Ale COL ABV VAL 6 %  	0 
COL Beer_Name VAL Big Bear Amber Ale COL Brew_Factory_Name VAL Frog Island Brewing Company COL Style VAL American Amber / Red Ale COL ABV VAL 6.00 %  	COL Beer_Name VAL Loose Shoe SlÃ ¡ inte Irish Red Ale COL Brew_Factory_Name VAL Saimaan Juomatehdas COL Style VAL Amber Ale COL ABV VAL 8 %  	0 
COL Beer_Name VAL Constanza _ ™ s Hoppy Red Ale COL Brew_Factory_Name VAL Edge Brewing COL Style VAL American Amber / Red Ale COL ABV VAL 8.00 %  	COL Beer_Name VAL Boxing Cat Firecracker Imperial Red Ale COL Brew_Factory_Name VAL Crazy Mountain Brewing Company COL Style VAL Amber Ale COL ABV VAL 6 %  	0 
COL Beer_Name VAL Big V Amber Ale COL Brew_Factory_Name VAL FreeWheel Brewing Company COL Style VAL American Amber / Red Ale COL ABV VAL 4.00 %  	COL Beer_Name VAL Slanted Rock Iron Butt Red Ale COL Brew_Factory_Name VAL Big Texan Brewery COL Style VAL Amber Ale COL ABV VAL 5 %  	0 
COL Beer_Name VAL Iron Mike 's Amber Ale COL Brew_Factory_Name VAL Alpha Brewing Company COL Style VAL American Amber / Red Ale COL ABV VAL 6.80 %  	COL Beer_Name VAL Red Horn Coffee House and Brewing Company Red Horn Drink Well Red Ale COL Brew_Factory_Name VAL Fat Bottom Brewery COL Style VAL Amber Ale COL ABV VAL 5 %  	0 
COL Beer_Name VAL Noggin Floggin ( Bourbon Barrel Aged ) COL Brew_Factory_Name VAL Picaroons Brewing Co. . COL Style VAL American Amber / Red Ale COL ABV VAL -  	COL Beer_Name VAL Big Choice Disconnected Red Ale COL Brew_Factory_Name VAL Heavy Seas Brewing Company COL Style VAL Amber Ale COL ABV VAL 5 %  	0 
COL Beer_Name VAL Red Emperor Amber Ale COL Brew_Factory_Name VAL Hoppy Brewing Co. . COL Style VAL American Amber / Red Ale COL ABV VAL 7.00 %  	COL Beer_Name VAL Swashbuckler Red Sea Amber Ale COL Brew_Factory_Name VAL Radiant Pig Beer Company COL Style VAL Barley Wine COL ABV VAL -  	0 
COL Beer_Name VAL Bourbon Barrel Aged Panama Red Ale COL Brew_Factory_Name VAL Stewart 's Brewing Co. . COL Style VAL American Amber / Red Ale COL ABV VAL 7.00 %  	COL Beer_Name VAL Speakeasy Wet Hop Prohibition Red Ale COL Brew_Factory_Name VAL Elevator Brewing Company COL Style VAL Amber Ale COL ABV VAL -  	0 
COL Beer_Name VAL Vital Infrared Imperial Red COL Brew_Factory_Name VAL Vital Brewing COL Style VAL American Amber / Red Ale COL ABV VAL 9.40 %  	COL Beer_Name VAL Vital Infrared Imperial Red COL Brew_Factory_Name VAL Vital Brewing COL Style VAL American Strong Ale COL ABV VAL 9.40 %  	1 
COL Beer_Name VAL Panama Limited Red Ale COL Brew_Factory_Name VAL Figure 8 Brewing COL Style VAL American Amber / Red Ale COL ABV VAL 9.10 %  	COL Beer_Name VAL Pizza Port Rhino Chaser Imperial Red Ale COL Brew_Factory_Name VAL Imperial Oak Brewing COL Style VAL Amber Ale COL ABV VAL -  	0 
COL Beer_Name VAL The `` Ginger '' A Red Ale COL Brew_Factory_Name VAL Flying Goose Brew Pub & Grille COL Style VAL American Amber / Red Ale COL ABV VAL 8.20 %  	COL Beer_Name VAL Swamp Head Sciaenhops Imperial Red Ale COL Brew_Factory_Name VAL Loose Shoe Brewing Company COL Style VAL Amber Ale COL ABV VAL -  	0 
COL Beer_Name VAL Broadhead Bourbon Barrel Aged Red COL Brew_Factory_Name VAL BearWaters Brewing Co. . COL Style VAL American Amber / Red Ale COL ABV VAL 5.00 %  	COL Beer_Name VAL Engine House No. 9 Rowdy Dick Amber Ale COL Brew_Factory_Name VAL Ecliptic Brewing COL Style VAL Amber Ale COL ABV VAL 8 %  	0 
COL Beer_Name VAL Big V Amber Ale COL Brew_Factory_Name VAL FreeWheel Brewing Company COL Style VAL American Amber / Red Ale COL ABV VAL 4.00 %  	COL Beer_Name VAL Golden City Centurion Barleywine Ale COL Brew_Factory_Name VAL Big Texan Brewery COL Style VAL Amber Ale COL ABV VAL 5 %  	0 
COL Beer_Name VAL Big V Amber Ale COL Brew_Factory_Name VAL Mad Anthony Brewing Company COL Style VAL American Amber / Red Ale COL ABV VAL 7.40 %  	COL Beer_Name VAL Sick N Twisted Naughty Redhead Imperial Red Ale COL Brew_Factory_Name VAL Big Rock Brewery COL Style VAL Amber Ale COL ABV VAL 5 %  	0 
COL Beer_Name VAL Extra Special Red Ale COL Brew_Factory_Name VAL Hawai'i Nui Brewing / Mehana Brewing Company COL Style VAL American Amber / Red Ale COL ABV VAL 6.20 %  	COL Beer_Name VAL Grand Canyon Sunset Amber Ale COL Brew_Factory_Name VAL Radiant Pig Beer Company COL Style VAL Amber Ale COL ABV VAL 5 %  	0 
COL Beer_Name VAL All American Red Ale COL Brew_Factory_Name VAL Baird Brewing Company / Fishmarket Taproom COL Style VAL American Amber / Red Ale COL ABV VAL 6.20 %  	COL Beer_Name VAL Thirsty Pagan North Coast Amber Ale COL Brew_Factory_Name VAL Big Horn Brewing Company &#40; Ram International &#41; COL Style VAL Amber Ale COL ABV VAL 5 %  	0 
COL Beer_Name VAL Vital Infrared Imperial Red COL Brew_Factory_Name VAL Vital Brewing COL Style VAL American Amber / Red Ale COL ABV VAL 9.40 %  	COL Beer_Name VAL Vital Infrared Imperial Red COL Brew_Factory_Name VAL Vital Brewing COL Style VAL American Strong Ale COL ABV VAL 9.40 %  	1 
COL Beer_Name VAL Jurassic Duck Amber Ale ( dry Hopped With Mosaic ) COL Brew_Factory_Name VAL Hoppy Brewing Co. . COL Style VAL American Amber / Red Ale COL ABV VAL -  	COL Beer_Name VAL Speakeasy Wet Hop Prohibition Red Ale COL Brew_Factory_Name VAL Brewsters Brewing Co. - Alberta COL Style VAL Amber Ale COL ABV VAL 6 %  	0 
COL Beer_Name VAL O'Connor 's Irish Red Ale COL Brew_Factory_Name VAL Elk Street Brewery & Tap Room COL Style VAL American Amber / Red Ale COL ABV VAL 5.00 %  	COL Beer_Name VAL Big Time Lift Ticket American Red Ale COL Brew_Factory_Name VAL The Beer Company COL Style VAL Irish Ale COL ABV VAL 7 %  	0 
COL Beer_Name VAL Fisherman 's Tea Party COL Brew_Factory_Name VAL Cape Ann Brewing Company COL Style VAL American Amber / Red Ale COL ABV VAL 9.00 %  	COL Beer_Name VAL Cape Ann Fisherman_s Tea Party COL Brew_Factory_Name VAL Cape Ann Brewing Company COL Style VAL American Strong Ale COL ABV VAL 9 %  	1 
COL Beer_Name VAL Bulleit Bourbon Barrel Aged G'Knight COL Brew_Factory_Name VAL Parallel 49 Brewing Company COL Style VAL American Amber / Red Ale COL ABV VAL 11.80 %  	COL Beer_Name VAL Destihl Barrel Aged Deadhead Double Red Ale COL Brew_Factory_Name VAL Iron Horse Brewery COL Style VAL Barley Wine COL ABV VAL -  	0 
COL Beer_Name VAL Barrel Aged Series : Barley Wine COL Brew_Factory_Name VAL Oskar Blues Grill & Brew COL Style VAL American Amber / Red Ale COL ABV VAL 11.80 %  	COL Beer_Name VAL Ale Mania Imperial Red Ale COL Brew_Factory_Name VAL AleSmith Brewing Company COL Style VAL Barley Wine COL ABV VAL -  	0 
COL Beer_Name VAL Mr. Grain Jeans Organic Amber Ale COL Brew_Factory_Name VAL Bomber Brewing COL Style VAL American Amber / Red Ale COL ABV VAL -  	COL Beer_Name VAL Lompoc Bourbon Barrel Aged Old Tavern Rat COL Brew_Factory_Name VAL Aspen Brewing Company COL Style VAL Amber Ale COL ABV VAL 6.50 %  	0 
COL Beer_Name VAL Morrisons American Red Ale COL Brew_Factory_Name VAL Edge Brewing COL Style VAL American Amber / Red Ale COL ABV VAL -  	COL Beer_Name VAL Heavy Seas Desert Island Series American Honey Amber Ale COL Brew_Factory_Name VAL Big Axe Brewery and B & B COL Style VAL Amber Ale COL ABV VAL 4.90 %  	0 
COL Beer_Name VAL Vital Infrared Imperial Red COL Brew_Factory_Name VAL Vital Brewing COL Style VAL American Amber / Red Ale COL ABV VAL 9.40 %  	COL Beer_Name VAL Vital Infrared Imperial Red COL Brew_Factory_Name VAL Vital Brewing COL Style VAL American Strong Ale COL ABV VAL 9.40 %  	1 
COL Beer_Name VAL Mountian Goat Rare Breed India Red Ale COL Brew_Factory_Name VAL Picaroons Brewing Co. . COL Style VAL American Amber / Red Ale COL ABV VAL 5.00 %  	COL Beer_Name VAL Central Coast Old Mission Amber Ale COL Brew_Factory_Name VAL Brewsters Brewing Co. - Alberta COL Style VAL Barley Wine COL ABV VAL -  	0 
COL Beer_Name VAL The `` Ginger '' A Red Ale COL Brew_Factory_Name VAL Wolf Hills Brewing Company COL Style VAL American Amber / Red Ale COL ABV VAL 4.90 %  	COL Beer_Name VAL Railway City Iron Spike Amber Ale COL Brew_Factory_Name VAL Big Spruce Brewing COL Style VAL Amber Ale COL ABV VAL -  	0 
COL Beer_Name VAL Pizza Orgasmica Amber Ale COL Brew_Factory_Name VAL Books & Brews COL Style VAL American Amber / Red Ale COL ABV VAL 6.50 %  	COL Beer_Name VAL Lompoc Bourbon Barrel Aged Old Tavern Rat COL Brew_Factory_Name VAL Pizza Port &#40; Solana Beach &#41; COL Style VAL Barley Wine COL ABV VAL -  	0 
COL Beer_Name VAL Bulleit Bourbon Barrel Aged G'Knight COL Brew_Factory_Name VAL Backpocket Brewing COL Style VAL American Amber / Red Ale COL ABV VAL 8.70 %  	COL Beer_Name VAL MadTree Bourbon Barrel Aged Happy Amber COL Brew_Factory_Name VAL MadTree Brewing Company COL Style VAL Amber Ale COL ABV VAL 6 %  	0 
COL Beer_Name VAL Big V Amber Ale COL Brew_Factory_Name VAL FreeWheel Brewing Company COL Style VAL American Amber / Red Ale COL ABV VAL 4.00 %  	COL Beer_Name VAL Golden City Centurion Barleywine Ale COL Brew_Factory_Name VAL Big Texan Brewery COL Style VAL Amber Ale COL ABV VAL 5 %  	0 
COL Beer_Name VAL Rhino Chaser Imperial Red Ale COL Brew_Factory_Name VAL Ruby River Steakhouse & Brewery COL Style VAL American Amber / Red Ale COL ABV VAL 7.40 %  	COL Beer_Name VAL Big Axe Maple Wheat Amber Ale COL Brew_Factory_Name VAL Slanted Rock Brewing Company COL Style VAL Amber Ale COL ABV VAL -  	0 
COL Beer_Name VAL Vital Infrared Imperial Red COL Brew_Factory_Name VAL Vital Brewing COL Style VAL American Amber / Red Ale COL ABV VAL 9.40 %  	COL Beer_Name VAL Vital Infrared Imperial Red COL Brew_Factory_Name VAL Vital Brewing COL Style VAL American Strong Ale COL ABV VAL 9.40 %  	1 
COL Beer_Name VAL Red Headed Slut Amber Ale COL Brew_Factory_Name VAL Hale 's Ales Brewery & Pub COL Style VAL American Amber / Red Ale COL ABV VAL 6.20 %  	COL Beer_Name VAL Oak Creek King Crimson Imperial Red Ale COL Brew_Factory_Name VAL Piney River Brewing Company COL Style VAL Amber Ale COL ABV VAL -  	0 
COL Beer_Name VAL 6th Anniversary Ale ( Dirty Hippie Imperial Red Ale ) COL Brew_Factory_Name VAL Kern River Brewing Company COL Style VAL American Amber / Red Ale COL ABV VAL 8.00 %  	COL Beer_Name VAL Brew Bus Detour Series : Rollin Dirty Red Ale - Wood Aged COL Brew_Factory_Name VAL Cigar City Brewing COL Style VAL Irish Ale COL ABV VAL 5 %  	0 
COL Beer_Name VAL Old Cascade Amber Ale COL Brew_Factory_Name VAL Flossmoor Station Restaurant & Brewery COL Style VAL American Amber / Red Ale COL ABV VAL 4.00 %  	COL Beer_Name VAL Anacapa Riptide Imperial Red Ale COL Brew_Factory_Name VAL Grand Canyon Brewing Company COL Style VAL Amber Ale COL ABV VAL 8 %  	0 
COL Beer_Name VAL Bulleit Bourbon Barrel Aged G'Knight COL Brew_Factory_Name VAL Oskar Blues Grill & Brew COL Style VAL American Amber / Red Ale COL ABV VAL 8.70 %  	COL Beer_Name VAL Lompoc Bourbon Barrel Aged Old Tavern Rat COL Brew_Factory_Name VAL Lompoc Brewing COL Style VAL Barley Wine COL ABV VAL 6 %  	0 
COL Beer_Name VAL Big V Amber Ale COL Brew_Factory_Name VAL Liquid Mechanics Brewing Co. . COL Style VAL American Amber / Red Ale COL ABV VAL 6.70 %  	COL Beer_Name VAL Kilted Dragon Bonnie Heather Amber Ale COL Brew_Factory_Name VAL Big Choice Brewing COL Style VAL Amber Ale COL ABV VAL 5 %  	0 
COL Beer_Name VAL Phobos Single Hop Red Ale COL Brew_Factory_Name VAL Heavy Seas Beer COL Style VAL American Amber / Red Ale COL ABV VAL 5.90 %  	COL Beer_Name VAL Big Choice Disconnected Red Ale COL Brew_Factory_Name VAL Amsterdam Brewing Company COL Style VAL Irish Ale COL ABV VAL -  	0 
COL Beer_Name VAL Simeon Jones River Valley Amber Ale COL Brew_Factory_Name VAL Black Husky Brewing COL Style VAL American Amber / Red Ale COL ABV VAL -  	COL Beer_Name VAL Pokertree Red Earl Ruby Ale COL Brew_Factory_Name VAL Big Texan Brewery COL Style VAL Amber Ale COL ABV VAL 5.50 %  	0 
COL Beer_Name VAL Phobos Single Hop Red Ale COL Brew_Factory_Name VAL Stilt House Brewery COL Style VAL American Amber / Red Ale COL ABV VAL 9.00 %  	COL Beer_Name VAL Iron Horse Fresh Hop Imperial Red Ale COL Brew_Factory_Name VAL Worthy Brewing Company COL Style VAL Amber Ale COL ABV VAL 8 %  	0 
COL Beer_Name VAL Mountian Goat Rare Breed India Red Ale COL Brew_Factory_Name VAL Petoskey Brewing Company COL Style VAL American Amber / Red Ale COL ABV VAL -  	COL Beer_Name VAL Golden City Centurion Barleywine Ale COL Brew_Factory_Name VAL Heinzelmannchen Brewery COL Style VAL Amber Ale COL ABV VAL 6 %  	0 
COL Beer_Name VAL Vital Infrared Imperial Red COL Brew_Factory_Name VAL Vital Brewing COL Style VAL American Amber / Red Ale COL ABV VAL 9.40 %  	COL Beer_Name VAL Vital Infrared Imperial Red COL Brew_Factory_Name VAL Vital Brewing COL Style VAL American Strong Ale COL ABV VAL 9.40 %  	1 
COL Beer_Name VAL Rocky Mountain Red Ale COL Brew_Factory_Name VAL Big Texan Brewery COL Style VAL American Amber / Red Ale COL ABV VAL 4.50 %  	COL Beer_Name VAL Crazy Mountain Boohai Red Ale &#40; Kura Koa &#41; COL Brew_Factory_Name VAL Sick N Twisted Brewing Company COL Style VAL Amber Ale COL ABV VAL -  	0 
COL Beer_Name VAL Vital Infrared Imperial Red COL Brew_Factory_Name VAL Vital Brewing COL Style VAL American Amber / Red Ale COL ABV VAL 9.40 %  	COL Beer_Name VAL Vital Infrared Imperial Red COL Brew_Factory_Name VAL Vital Brewing COL Style VAL American Strong Ale COL ABV VAL 9.40 %  	1 
COL Beer_Name VAL Bulleit Bourbon Barrel Aged G'Knight COL Brew_Factory_Name VAL Oskar Blues Grill & Brew COL Style VAL American Amber / Red Ale COL ABV VAL 8.70 %  	COL Beer_Name VAL Lompoc Bourbon Barrel Aged Old Tavern Rat COL Brew_Factory_Name VAL Lompoc Brewing COL Style VAL Barley Wine COL ABV VAL 6 %  	0 
COL Beer_Name VAL Big V Amber Ale COL Brew_Factory_Name VAL FreeWheel Brewing Company COL Style VAL American Amber / Red Ale COL ABV VAL 4.00 %  	COL Beer_Name VAL Heinzelmannchen Big Amber Gnome Ale COL Brew_Factory_Name VAL Big Horn Brewing Company &#40; Ram International &#41; COL Style VAL Amber Ale COL ABV VAL 5 %  	0 
COL Beer_Name VAL Weekender American Amber Ale COL Brew_Factory_Name VAL OPA-OPA Steakhouse & Brewery COL Style VAL American Amber / Red Ale COL ABV VAL 6.00 %  	COL Beer_Name VAL Mad River Jamaica Red Ale COL Brew_Factory_Name VAL Saimaan Juomatehdas COL Style VAL Amber Ale COL ABV VAL -  	0 
COL Beer_Name VAL Alaskan Barley Wine ( Pilot Series ) COL Brew_Factory_Name VAL Flying Goose Brew Pub & Grille COL Style VAL American Amber / Red Ale COL ABV VAL -  	COL Beer_Name VAL Anderson Valley Barrel Aged Horn of the Beer Barley Wine COL Brew_Factory_Name VAL Anderson Valley Brewing Company COL Style VAL Barley Wine COL ABV VAL 8.60 %  	0 
COL Beer_Name VAL Bulleit Bourbon Barrel Aged G'Knight COL Brew_Factory_Name VAL Oskar Blues Grill & Brew COL Style VAL American Amber / Red Ale COL ABV VAL 8.70 %  	COL Beer_Name VAL Lompoc Bourbon Barrel Aged Old Tavern Rat COL Brew_Factory_Name VAL Lompoc Brewing COL Style VAL Barley Wine COL ABV VAL 6 %  	0 
COL Beer_Name VAL Aiken American Red Pale Ale COL Brew_Factory_Name VAL Aiken Brewing Company COL Style VAL American Amber / Red Ale COL ABV VAL -  	COL Beer_Name VAL Maldita Old Continent American Amber Ale COL Brew_Factory_Name VAL Blue Heron Brewpub COL Style VAL Amber Ale COL ABV VAL 6 %  	0 
COL Beer_Name VAL Sequoia American Amber Ale COL Brew_Factory_Name VAL Big Texan Brewery COL Style VAL American Amber / Red Ale COL ABV VAL 8.00 %  	COL Beer_Name VAL Central Coast Old Mission Amber Ale COL Brew_Factory_Name VAL Canal Park Brewing Company COL Style VAL Amber Ale COL ABV VAL 5 %  	0 
COL Beer_Name VAL Smuttynose Kindest Find Imperial Red Ale COL Brew_Factory_Name VAL Flying Goose Brew Pub & Grille COL Style VAL American Amber / Red Ale COL ABV VAL 11.20 %  	COL Beer_Name VAL Legacy Bourbon Barrel Hedonism Red COL Brew_Factory_Name VAL Liberty Brewery & Grill - High Point COL Style VAL Barley Wine COL ABV VAL -  	0 
COL Beer_Name VAL Pioneer American Red Ale COL Brew_Factory_Name VAL Short 's Brewing Company COL Style VAL American Amber / Red Ale COL ABV VAL 8.00 %  	COL Beer_Name VAL Brew Bus Detour Series : Rollin Dirty Red Ale - Wood Aged COL Brew_Factory_Name VAL Cigar City Brewing COL Style VAL Irish Ale COL ABV VAL 5 %  	0 
COL Beer_Name VAL All American Red Ale COL Brew_Factory_Name VAL Hawai'i Nui Brewing / Mehana Brewing Company COL Style VAL American Amber / Red Ale COL ABV VAL 8.20 %  	COL Beer_Name VAL Canal Park General Sterling Price American Amber Ale - Centennial COL Brew_Factory_Name VAL Big Time Brewery COL Style VAL Amber Ale COL ABV VAL -  	0 
COL Beer_Name VAL Sequoia American Amber Ale COL Brew_Factory_Name VAL Centennial Beer Co. . COL Style VAL American Amber / Red Ale COL ABV VAL 11.00 %  	COL Beer_Name VAL Nighthawk 16-Hour Dry Hopped Amber COL Brew_Factory_Name VAL Purrumbete Brewing COL Style VAL Amber Ale COL ABV VAL -  	0 
COL Beer_Name VAL Blood On The Blade Red IPA COL Brew_Factory_Name VAL Beachwood BBQ & Brewing COL Style VAL American Amber / Red Ale COL ABV VAL -  	COL Beer_Name VAL Off the Rail Raybuck Red Ale COL Brew_Factory_Name VAL Wild Ride Brewing COL Style VAL Amber Ale COL ABV VAL 7.50 %  	0 
COL Beer_Name VAL Sea Spray Amber Ale COL Brew_Factory_Name VAL Hawai'i Nui Brewing / Mehana Brewing Company COL Style VAL American Amber / Red Ale COL ABV VAL 9.10 %  	COL Beer_Name VAL Legacy Bourbon Barrel Hedonism Red COL Brew_Factory_Name VAL Piney River Brewing Company COL Style VAL Amber Ale COL ABV VAL -  	0 
COL Beer_Name VAL Sea Spray Amber Ale COL Brew_Factory_Name VAL Ruby River Steakhouse & Brewery COL Style VAL American Amber / Red Ale COL ABV VAL -  	COL Beer_Name VAL De Koninck TSTBRW 01 Imperial Red Ale COL Brew_Factory_Name VAL Proof Brewing Company COL Style VAL Amber Ale COL ABV VAL 5 %  	0 
COL Beer_Name VAL Red Rose Amber Ale COL Brew_Factory_Name VAL Alpha Brewing Company COL Style VAL American Amber / Red Ale COL ABV VAL 4.50 %  	COL Beer_Name VAL Saimaan Brewer_s Special American Red Ale COL Brew_Factory_Name VAL Ecliptic Brewing COL Style VAL Amber Ale COL ABV VAL -  	0 
COL Beer_Name VAL Ro Shampo Imperial Red Ale COL Brew_Factory_Name VAL BridgePort Brewing Co. / Brewpub COL Style VAL American Amber / Red Ale COL ABV VAL 7.00 %  	COL Beer_Name VAL Amsterdam X Sawdust City X Great Lakes X Indie Ale Barley Wine &#40; Oak &#41; COL Brew_Factory_Name VAL Wildcard Brewing Company COL Style VAL Barley Wine COL ABV VAL -  	0 
COL Beer_Name VAL Extra Special Red Ale COL Brew_Factory_Name VAL Great River Brewery COL Style VAL American Amber / Red Ale COL ABV VAL 8.50 %  	COL Beer_Name VAL Genesee Brew House American Red Ale COL Brew_Factory_Name VAL Off the Rail Brewing COL Style VAL Amber Ale COL ABV VAL 9 %  	0 
COL Beer_Name VAL Molly American Red Ale COL Brew_Factory_Name VAL Backpocket Brewing COL Style VAL American Amber / Red Ale COL ABV VAL 7.00 %  	COL Beer_Name VAL Bacchus / Burrow Bloodhound Blood Red IPA COL Brew_Factory_Name VAL Bacchus Brewing Company &#40; Australia &#41; COL Style VAL India Pale Ale &#40; IPA &#41; COL ABV VAL 6 %  	0 
COL Beer_Name VAL Big V Amber Ale COL Brew_Factory_Name VAL FreeWheel Brewing Company COL Style VAL American Amber / Red Ale COL ABV VAL 4.00 %  	COL Beer_Name VAL Swashbuckler Red Sea Amber Ale COL Brew_Factory_Name VAL Big Texan Brewery COL Style VAL Amber Ale COL ABV VAL 5 %  	0 
COL Beer_Name VAL Stupiphany Imperial Red Ale COL Brew_Factory_Name VAL Titanic Brewery COL Style VAL American Amber / Red Ale COL ABV VAL -  	COL Beer_Name VAL Engine House No. 9 Rowdy Dick Amber Ale COL Brew_Factory_Name VAL Lancaster Brewing Co. . COL Style VAL Barley Wine COL ABV VAL 5 %  	0 
COL Beer_Name VAL Vital Infrared Imperial Red COL Brew_Factory_Name VAL Vital Brewing COL Style VAL American Amber / Red Ale COL ABV VAL 9.40 %  	COL Beer_Name VAL Vital Infrared Imperial Red COL Brew_Factory_Name VAL Vital Brewing COL Style VAL American Strong Ale COL ABV VAL 9.40 %  	1 
COL Beer_Name VAL Mountian Goat Rare Breed India Red Ale COL Brew_Factory_Name VAL Brannon 's Pub and Brewery COL Style VAL American Amber / Red Ale COL ABV VAL -  	COL Beer_Name VAL Wild Ride 3 Sisters American Red Ale COL Brew_Factory_Name VAL Ballast Point Brewing Company COL Style VAL Amber Ale COL ABV VAL 10 %  	0 
COL Beer_Name VAL Red Dragon Smoked Amber Ale COL Brew_Factory_Name VAL Aspetuck Brew Lab COL Style VAL American Amber / Red Ale COL ABV VAL 4.00 %  	COL Beer_Name VAL Flat 12 Barrel Aged Moustache Ride Red COL Brew_Factory_Name VAL Midnight Sun Brewing Company COL Style VAL Amber Ale COL ABV VAL 5 %  	0 
COL Beer_Name VAL Clifford The Big Red Ale COL Brew_Factory_Name VAL Twisted K-8 Brewing Company COL Style VAL American Amber / Red Ale COL ABV VAL 5.50 %  	COL Beer_Name VAL Iron Horse Fresh Hop Imperial Red Ale COL Brew_Factory_Name VAL Iron Horse Brewery COL Style VAL Barley Wine COL ABV VAL -  	0 
COL Beer_Name VAL Molly American Red Ale COL Brew_Factory_Name VAL Backpocket Brewing COL Style VAL American Amber / Red Ale COL ABV VAL 7.00 %  	COL Beer_Name VAL Bacchus / Burrow Bloodhound Blood Red IPA COL Brew_Factory_Name VAL Bacchus Brewing Company &#40; Australia &#41; COL Style VAL India Pale Ale &#40; IPA &#41; COL ABV VAL 6 %  	0 
COL Beer_Name VAL Alaskan Imperial Red Ale ( Pilot Series ) COL Brew_Factory_Name VAL Otto 's Pub and Brewery COL Style VAL American Amber / Red Ale COL ABV VAL -  	COL Beer_Name VAL Elevator Barrel Aged Barley Wine COL Brew_Factory_Name VAL Elevator Brewing Company COL Style VAL Barley Wine COL ABV VAL 6.50 %  	0 
COL Beer_Name VAL Vital Infrared Imperial Red COL Brew_Factory_Name VAL Vital Brewing COL Style VAL American Amber / Red Ale COL ABV VAL 9.40 %  	COL Beer_Name VAL Vital Infrared Imperial Red COL Brew_Factory_Name VAL Vital Brewing COL Style VAL American Strong Ale COL ABV VAL 9.40 %  	1 
COL Beer_Name VAL Vital Infrared Imperial Red COL Brew_Factory_Name VAL Vital Brewing COL Style VAL American Amber / Red Ale COL ABV VAL 9.40 %  	COL Beer_Name VAL Vital Infrared Imperial Red COL Brew_Factory_Name VAL Vital Brewing COL Style VAL American Strong Ale COL ABV VAL 9.40 %  	1 
COL Beer_Name VAL Vital Infrared Imperial Red COL Brew_Factory_Name VAL Vital Brewing COL Style VAL American Amber / Red Ale COL ABV VAL 9.40 %  	COL Beer_Name VAL Vital Infrared Imperial Red COL Brew_Factory_Name VAL Vital Brewing COL Style VAL American Strong Ale COL ABV VAL 9.40 %  	1 
COL Beer_Name VAL Big Bully Amber Ale COL Brew_Factory_Name VAL Hawai'i Nui Brewing / Mehana Brewing Company COL Style VAL American Amber / Red Ale COL ABV VAL 4.50 %  	COL Beer_Name VAL Aarhus Cains Triple A American Amber Ale COL Brew_Factory_Name VAL Cigar City Brewing COL Style VAL Amber Ale COL ABV VAL -  	0 
COL Beer_Name VAL Road Rash Red COL Brew_Factory_Name VAL Alpha Brewing Company COL Style VAL American Amber / Red Ale COL ABV VAL -  	COL Beer_Name VAL Pokertree Red Earl Ruby Ale COL Brew_Factory_Name VAL Aarhus Bryghus COL Style VAL Amber Ale COL ABV VAL 8 %  	0 
COL Beer_Name VAL Isle Of Pines Barley Wine COL Brew_Factory_Name VAL Beachwood BBQ & Brewing COL Style VAL American Amber / Red Ale COL ABV VAL -  	COL Beer_Name VAL Anderson Valley Barrel Aged Horn of the Beer Barley Wine COL Brew_Factory_Name VAL Barley_s Brewing Company COL Style VAL Barley Wine COL ABV VAL 8.60 %  	0 
COL Beer_Name VAL Big V Amber Ale COL Brew_Factory_Name VAL Wig And Pen COL Style VAL American Amber / Red Ale COL ABV VAL 4.00 %  	COL Beer_Name VAL Cigar City Cold Brew Series - Red Ale COL Brew_Factory_Name VAL Anderson Valley Brewing Company COL Style VAL Irish Ale COL ABV VAL 5 %  	0 
COL Beer_Name VAL Hurricane Alley Amber Ale COL Brew_Factory_Name VAL Flossmoor Station Restaurant & Brewery COL Style VAL American Amber / Red Ale COL ABV VAL -  	COL Beer_Name VAL Aarhus Cains Triple A American Amber Ale COL Brew_Factory_Name VAL Boxing Cat Brewery COL Style VAL Amber Ale COL ABV VAL 7.50 %  	0 
COL Beer_Name VAL Wasatch 50th Park City Golden Anniversary Ale COL Brew_Factory_Name VAL Wolf Hills Brewing Company COL Style VAL American Amber / Red Ale COL ABV VAL 12.50 %  	COL Beer_Name VAL Crazy Mountain Boohai Red Ale &#40; Kura Koa &#41; COL Brew_Factory_Name VAL Big Spruce Brewing COL Style VAL Amber Ale COL ABV VAL -  	0 
COL Beer_Name VAL Constanza _ ™ s Hoppy Red Ale COL Brew_Factory_Name VAL Abita Brewing Co. . COL Style VAL American Amber / Red Ale COL ABV VAL 6.80 %  	COL Beer_Name VAL Sick N Twisted Naughty Redhead Imperial Red Ale COL Brew_Factory_Name VAL Worthy Brewing Company COL Style VAL Amber Ale COL ABV VAL -  	0 
COL Beer_Name VAL Red Shedman 's Imperial Amber Ale COL Brew_Factory_Name VAL Great River Brewery COL Style VAL American Amber / Red Ale COL ABV VAL 8.20 %  	COL Beer_Name VAL Peter Bs Sum Of Hours Imperial Red Ale COL Brew_Factory_Name VAL Ale Mania &#40; Fritz Ale &#41; COL Style VAL Barley Wine COL ABV VAL 9 %  	0 
COL Beer_Name VAL Stupiphany Imperial Red Ale COL Brew_Factory_Name VAL Greenpoint Beerworks / Kelso of Brooklyn COL Style VAL American Amber / Red Ale COL ABV VAL -  	COL Beer_Name VAL Ecliptic Phobos Extra Red Ale COL Brew_Factory_Name VAL Worthy Brewing Company COL Style VAL Irish Ale COL ABV VAL 8 %  	0 
COL Beer_Name VAL West Sixth / Country Boy Country Western ( Volume 3 Imperial Red Ale ) COL Brew_Factory_Name VAL Backpocket Brewing COL Style VAL American Amber / Red Ale COL ABV VAL -  	COL Beer_Name VAL Brewsters Winter WARMer Amber Ale COL Brew_Factory_Name VAL Fat Bottom Brewery COL Style VAL Amber Ale COL ABV VAL 6 %  	0 
COL Beer_Name VAL Red Rock Amber Ale COL Brew_Factory_Name VAL OPA-OPA Steakhouse & Brewery COL Style VAL American Amber / Red Ale COL ABV VAL 4.50 %  	COL Beer_Name VAL Cape Cod Bourbon Barrel Red COL Brew_Factory_Name VAL Stadin Panimo COL Style VAL Amber Ale COL ABV VAL -  	0 
COL Beer_Name VAL Red Dragon Smoked Amber Ale COL Brew_Factory_Name VAL Hoppy Brewing Co. . COL Style VAL American Amber / Red Ale COL ABV VAL 5.50 %  	COL Beer_Name VAL Iron Horse Fresh Hop Imperial Red Ale COL Brew_Factory_Name VAL Anheuser-Busch InBev COL Style VAL Amber Ale COL ABV VAL -  	0 
COL Beer_Name VAL Double Dragon Imperial Red Ale COL Brew_Factory_Name VAL Alaskan Brewing Co. . COL Style VAL American Amber / Red Ale COL ABV VAL 9.00 %  	COL Beer_Name VAL Hangar 24 Barrel Roll No. 04 : Hammerhead - Bourbon Barrel Aged with Chai Tea COL Brew_Factory_Name VAL Brewsters Brewing Co. - Alberta COL Style VAL Barley Wine COL ABV VAL 6 %  	0 
COL Beer_Name VAL All American Red Ale COL Brew_Factory_Name VAL Black Husky Brewing COL Style VAL American Amber / Red Ale COL ABV VAL 4.00 %  	COL Beer_Name VAL Big Axe Maple Wheat Amber Ale COL Brew_Factory_Name VAL Sick N Twisted Brewing Company COL Style VAL Amber Ale COL ABV VAL 5 %  	0 
COL Beer_Name VAL Deputation Imperial Red Ale COL Brew_Factory_Name VAL Otto 's Pub and Brewery COL Style VAL American Amber / Red Ale COL ABV VAL 13.00 %  	COL Beer_Name VAL Railway City Iron Spike Amber Ale COL Brew_Factory_Name VAL Spiteful Brewing COL Style VAL Irish Ale COL ABV VAL 8 %  	0 
COL Beer_Name VAL Stone Liberty Station Outbreak Series : Red Ale COL Brew_Factory_Name VAL Elk Street Brewery & Tap Room COL Style VAL American Amber / Red Ale COL ABV VAL 5.00 %  	COL Beer_Name VAL Piney River McKinney Eddy Amber Ale COL Brew_Factory_Name VAL Kettle House Brewing Company COL Style VAL Amber Ale COL ABV VAL -  	0 
COL Beer_Name VAL Molly American Red Ale COL Brew_Factory_Name VAL Outpost Natural Foods COL Style VAL American Amber / Red Ale COL ABV VAL 7.00 %  	COL Beer_Name VAL Bacchus / Burrow Bloodhound Blood Red IPA COL Brew_Factory_Name VAL Big Time Brewery COL Style VAL India Pale Ale &#40; IPA &#41; COL ABV VAL 6 %  	0 
COL Beer_Name VAL Vital Infrared Imperial Red COL Brew_Factory_Name VAL Vital Brewing COL Style VAL American Amber / Red Ale COL ABV VAL 9.40 %  	COL Beer_Name VAL Vital Infrared Imperial Red COL Brew_Factory_Name VAL Vital Brewing COL Style VAL American Strong Ale COL ABV VAL 9.40 %  	1 
COL Beer_Name VAL Molly American Red Ale COL Brew_Factory_Name VAL Elk Street Brewery & Tap Room COL Style VAL American Amber / Red Ale COL ABV VAL 5.00 %  	COL Beer_Name VAL Loose Shoe SlÃ ¡ inte Irish Red Ale COL Brew_Factory_Name VAL The Beer Company COL Style VAL Irish Ale COL ABV VAL 7 %  	0 
COL Beer_Name VAL The `` Ginger '' A Red Ale COL Brew_Factory_Name VAL Wormtown Brewery COL Style VAL American Amber / Red Ale COL ABV VAL 5.00 %  	COL Beer_Name VAL The Beer Company Wyatt Earp Red Ale COL Brew_Factory_Name VAL Loose Shoe Brewing Company COL Style VAL Irish Ale COL ABV VAL 7 %  	0 
COL Beer_Name VAL Big V Amber Ale COL Brew_Factory_Name VAL FreeWheel Brewing Company COL Style VAL American Amber / Red Ale COL ABV VAL 4.00 %  	COL Beer_Name VAL Golden City Centurion Barleywine Ale COL Brew_Factory_Name VAL Big Texan Brewery COL Style VAL Amber Ale COL ABV VAL 5 %  	0 
COL Beer_Name VAL Double Dragon Imperial Red Ale COL Brew_Factory_Name VAL Backpocket Brewing COL Style VAL American Amber / Red Ale COL ABV VAL 6.80 %  	COL Beer_Name VAL Fat Bottom Ruby Red American Ale COL Brew_Factory_Name VAL Boxing Cat Brewery COL Style VAL Amber Ale COL ABV VAL -  	0 
COL Beer_Name VAL 6th Anniversary Ale ( Dirty Hippie Imperial Red Ale ) COL Brew_Factory_Name VAL Kern River Brewing Company COL Style VAL American Amber / Red Ale COL ABV VAL 8.00 %  	COL Beer_Name VAL Brew Bus Detour Series : Rollin Dirty Red Ale - Wood Aged COL Brew_Factory_Name VAL Cigar City Brewing COL Style VAL Irish Ale COL ABV VAL 5 %  	0 
COL Beer_Name VAL Bulleit Bourbon Barrel Aged G'Knight COL Brew_Factory_Name VAL Oskar Blues Grill & Brew COL Style VAL American Amber / Red Ale COL ABV VAL 8.70 %  	COL Beer_Name VAL Lompoc Bourbon Barrel Aged Old Tavern Rat COL Brew_Factory_Name VAL Lompoc Brewing COL Style VAL Barley Wine COL ABV VAL 6 %  	0 
COL Beer_Name VAL Constanza _ ™ s Hoppy Red Ale COL Brew_Factory_Name VAL Mountain Goat Beer Pty Ltd COL Style VAL American Amber / Red Ale COL ABV VAL 9.00 %  	COL Beer_Name VAL Maldita Old Continent American Amber Ale COL Brew_Factory_Name VAL Nighthawk Brewery COL Style VAL Amber Ale COL ABV VAL 6 %  	0 
COL Beer_Name VAL Pizza Orgasmica Amber Ale COL Brew_Factory_Name VAL Otto 's Pub and Brewery COL Style VAL American Amber / Red Ale COL ABV VAL 6.50 %  	COL Beer_Name VAL Anderson Valley Barrel Aged Horn of the Beer Barley Wine COL Brew_Factory_Name VAL Baird Brewing Co. . COL Style VAL Barley Wine COL ABV VAL -  	0 
COL Beer_Name VAL Ruby River Ruby Red Ale COL Brew_Factory_Name VAL Outpost Natural Foods COL Style VAL American Amber / Red Ale COL ABV VAL 6.00 %  	COL Beer_Name VAL Charleville Tornado Alley Amber Ale COL Brew_Factory_Name VAL Big Rock Brewery COL Style VAL Amber Ale COL ABV VAL 5 %  	0 
COL Beer_Name VAL Red Rock Amber Ale COL Brew_Factory_Name VAL Salty Nut Brewery COL Style VAL American Amber / Red Ale COL ABV VAL 4.50 %  	COL Beer_Name VAL Big Horn Buttface Amber Ale COL Brew_Factory_Name VAL Engine House No. 9 Restaurant and Brewery COL Style VAL Amber Ale COL ABV VAL -  	0 
COL Beer_Name VAL Vital Infrared Imperial Red COL Brew_Factory_Name VAL Vital Brewing COL Style VAL American Amber / Red Ale COL ABV VAL 9.40 %  	COL Beer_Name VAL Vital Infrared Imperial Red COL Brew_Factory_Name VAL Vital Brewing COL Style VAL American Strong Ale COL ABV VAL 9.40 %  	1 
COL Beer_Name VAL Mr. Grain Jeans Organic Amber Ale COL Brew_Factory_Name VAL Hawai'i Nui Brewing / Mehana Brewing Company COL Style VAL American Amber / Red Ale COL ABV VAL 5.00 %  	COL Beer_Name VAL Blue Star Apache Amber Ale COL Brew_Factory_Name VAL Speakeasy Ales and Lagers COL Style VAL Amber Ale COL ABV VAL 6 %  	0 
COL Beer_Name VAL Wasatch 50th Park City Golden Anniversary Ale COL Brew_Factory_Name VAL Figure 8 Brewing COL Style VAL American Amber / Red Ale COL ABV VAL -  	COL Beer_Name VAL Big Spruce Ready Yer Knot ... Regatta Red Ale COL Brew_Factory_Name VAL Proof Brewing Company COL Style VAL Amber Ale COL ABV VAL 5.60 %  	0 
COL Beer_Name VAL Ulysses Imperial Red Ale COL Brew_Factory_Name VAL Stilt House Brewery COL Style VAL American Amber / Red Ale COL ABV VAL 5.00 %  	COL Beer_Name VAL Swashbuckler Red Sea Amber Ale COL Brew_Factory_Name VAL Midnight Sun Brewing Company COL Style VAL Amber Ale COL ABV VAL -  	0 
COL Beer_Name VAL Texas Red Amber Ale COL Brew_Factory_Name VAL Phillips Brewing Company COL Style VAL American Amber / Red Ale COL ABV VAL 4.00 %  	COL Beer_Name VAL Big Choice Disconnected Red Ale COL Brew_Factory_Name VAL Engine House No. 9 Restaurant and Brewery COL Style VAL Barley Wine COL ABV VAL -  	0 
COL Beer_Name VAL Iron Mike 's Amber Ale COL Brew_Factory_Name VAL Tornado Brewing Company COL Style VAL American Amber / Red Ale COL ABV VAL -  	COL Beer_Name VAL Big Horn Buttface Amber Ale COL Brew_Factory_Name VAL Engine House No. 9 Restaurant and Brewery COL Style VAL Amber Ale COL ABV VAL 7.70 %  	0 
COL Beer_Name VAL Old Cascade Amber Ale COL Brew_Factory_Name VAL Petoskey Brewing Company COL Style VAL American Amber / Red Ale COL ABV VAL -  	COL Beer_Name VAL Swashbuckler Red Sea Amber Ale COL Brew_Factory_Name VAL Fat Bottom Brewery COL Style VAL Amber Ale COL ABV VAL 5 %  	0 
COL Beer_Name VAL 6th Anniversary Ale ( Dirty Hippie Imperial Red Ale ) COL Brew_Factory_Name VAL Kern River Brewing Company COL Style VAL American Amber / Red Ale COL ABV VAL -  	COL Beer_Name VAL Brew Bus Detour Series : Rollin Dirty Red Ale - Wood Aged COL Brew_Factory_Name VAL Cigar City Brewing COL Style VAL Irish Ale COL ABV VAL 5 %  	0 
COL Beer_Name VAL Aiken American Red Pale Ale COL Brew_Factory_Name VAL The Civil Life Brewing Company COL Style VAL American Amber / Red Ale COL ABV VAL -  	COL Beer_Name VAL Engine House No. 9 Rowdy Dick Amber Ale COL Brew_Factory_Name VAL Heinzelmannchen Brewery COL Style VAL Amber Ale COL ABV VAL 6.50 %  	0 
COL Beer_Name VAL The `` Ginger '' A Red Ale COL Brew_Factory_Name VAL Wormtown Brewery COL Style VAL American Amber / Red Ale COL ABV VAL 5.00 %  	COL Beer_Name VAL The Beer Company Wyatt Earp Red Ale COL Brew_Factory_Name VAL Liberty Brewery & Grill - High Point COL Style VAL Irish Ale COL ABV VAL 7 %  	0 
COL Beer_Name VAL Big V Amber Ale COL Brew_Factory_Name VAL FreeWheel Brewing Company COL Style VAL American Amber / Red Ale COL ABV VAL 4.00 %  	COL Beer_Name VAL Golden City Centurion Barleywine Ale COL Brew_Factory_Name VAL Big Texan Brewery COL Style VAL Amber Ale COL ABV VAL 5 %  	0 
COL Beer_Name VAL 6th Anniversary Ale ( Dirty Hippie Imperial Red Ale ) COL Brew_Factory_Name VAL Kern River Brewing Company COL Style VAL American Amber / Red Ale COL ABV VAL 8.00 %  	COL Beer_Name VAL Brew Bus Detour Series : Rollin Dirty Red Ale - Wood Aged COL Brew_Factory_Name VAL Cigar City Brewing COL Style VAL Irish Ale COL ABV VAL 5 %  	0 
